阿佐塞米片	药物
乳腺胀痛	症状
上臂短于前臂，小腿短于大腿	NoneType
红霉素肠溶片	药物
富马酸亚铁咀嚼片	药物
氢溴酸高乌甲素片	药物
赔偿神经症	疾病
抗菌痢灵片	药物
醒脾养儿颗粒	药物
指甲、耳软骨出现褐色色素沉着	NoneType
复方四维女贞子胶囊	药物
方肩畸形	症状
维生素D缺乏病	疾病
外阴淋巴管瘤	疾病
胶质母细胞瘤	疾病
三味止咳片	药物
降糖宁	药物
利培酮口服液	药物
磺胺间甲氧嘧啶片	药物
氨咖黄敏颗粒	药物
蛤蚧治痨丸	药物
穿凿样改变颅骨破坏	症状
肩锁关节脱位	疾病
小儿继发性免疫缺陷病	疾病
玉泉散	药物
复方杜鹃片	药物
食管出血	症状
胃潴留	疾病
烫疮油	药物
谷维素注射液	药物
治带片	药物
环磷酸鸟苷	检查科目
康妇炎胶囊	药物
ABO血型定型试剂	药物
槐假尾孢	NoneType
心血管内科	医学专科
腕舟状骨骨折	疾病
左上腹痛	症状
吡洛芬	药物
Reis-Bucklers角膜营养不良	疾病
鼻黏膜可呈颗粒状易碎的结痂	症状
尖头并指	症状
复方胱氨酸片	药物
投掷运动	疾病
肝臭	症状
稀莶丸	药物
骨骼肿块	症状
免疫缺陷	NoneType
祛风除湿药酒	药物
软腭癌	疾病
四环素胶囊	药物
附睾肿大发硬	症状
复方氢氧化铝镁片	药物
非溃疡消化不良	疾病
维血宁糖浆	药物
积液乳酸脱氢酶	检查科目
全身各脏器血流缓慢	症状
水飞蓟素	药物
克拉维酸钾羟氨苄青霉素颗粒剂	药物
视力常呈雾状模糊感	症状
利福喷汀	药物
接骨片	药物
舒康洗液	药物
乌丹降脂颗粒	药物
急性淋巴细胞白血病	疾病
厌氧菌肺炎	疾病
金骨莲胶囊	药物
白血病性咽峡炎	疾病
大疱性表皮松解	疾病
宽褶奥德蘑	NoneType
传导性腹痛	症状
妇得康泡沫剂	药物
清感穿心莲胶囊	药物
第三代毒品	NoneType
小儿上火	症状
化积口服液	药物
过分地惊跳反应	症状
九味双解口服液	药物
单硫酸卡那霉素	药物
注射用硫酸头孢匹罗	药物
阿魏酸钠葡萄糖注射液	药物
考来替兰	药物
活血风寒膏	药物
先天性肺动静脉瘘	疾病
芩草止痢片	药物
髋外侧可见皮下瘀血斑	症状
粪便带绿色	症状
肝硬化性肾损害	疾病
四氯乙烯	药物
黏多糖贮积症Ⅶ型	NoneType
家族性甲状腺非髓样癌	疾病
参蛤补肺胶囊	药物
小儿葡萄糖-6-磷酸脱氢酶缺乏症	疾病
先天性胆总管囊肿	疾病
“E”字征	症状
伤风停胶囊	药物
正骨水	药物
生脉颗粒(党参方)	药物
达那唑栓	药物
盐酸阿奇霉素注射液	药物
胆龙止喘片	药物
性变态	疾病
椎管内结核瘤	疾病
脑塞安胶囊	药物
皮肤淋巴细胞浸润症	疾病
赖氨匹林肠溶片	药物
回生甘露丸	药物
泪液pH	检查科目
梅尼埃病	疾病
活血应痛丸	药物
寰枢关节不稳定	症状
三七丹参胶囊	药物
交替使用双眼	NoneType
复方曼陀罗药水	药物
头目晕沉	症状
赛金化毒散	药物
产后自汗盗汗	症状
金佛止痛丸	药物
正常颅压脑积水	疾病
骶骨囊肿	疾病
过敏性血管炎	疾病
联苯苄唑涂膜	药物
注射用盐酸左氧氟沙星	药物
萘普生缓释胶囊	药物
伤痛克酊	药物
复方茶碱片	药物
曲安缩松尿素软膏	药物
苦参素注射液	药物
舌震颤	症状
肠癌	疾病
类癌面红	症状
急性化脓性脑膜炎	疾病
氧化锌硫软膏	药物
脊髓内出血	疾病
乙型肝炎病毒表面抗原诊断试剂盒(放射免疫法)	药物
眼干涩酸胀，易疲劳	NoneType
原发性皮肤滤泡中心细胞性淋巴瘤	疾病
萘普生钠伪麻黄碱缓释片	药物
依美斯汀	药物
洛伐他汀胶囊	药物
阴道持续少量流血	症状
巴顿骨折	疾病
18种氨基酸注射液	药物
注射用阿莫西林钠氟氯西林钠	药物
米非司酮胶丸	药物
产后三急	疾病
酒精依赖	症状
舒更胶囊	药物
乙型肝炎病毒e抗体诊断试剂盒(放射免疫法)	药物
甲型肝炎抗体	检查科目
盐酸胺碘酮片	药物
气道和食管之间的瘘管	症状
牛黄消炎灵胶囊	药物
补骨脂素	药物
卫生宝丸	药物
倍他胡萝卜素	药物
空巢综合症	疾病
复肾宁片	药物
益肾养元合剂	药物
急性出血性坏死性小肠炎	疾病
冻干静注人免疫球蛋白	药物
口咽异物	症状
肠壁坏死	症状
氟罗沙星分散片	药物
骨风宁胶囊	药物
氯化钾葡萄糖注射液	药物
结核性阴道炎	疾病
石榴健胃散	药物
门脉高压	NoneType
山药参芪丸	药物
葛根芩连口服液	药物
柏哲病	疾病
气管间隙形成肿块	症状
脑挫裂伤	疾病
多囊肝	症状
儿茶酚胺	检查科目
丹皮酚	药物
虫证	疾病
硝酸益康唑喷剂	药物
复方两面针漱齿液	药物
石淋通胶囊	药物
唾液睾酮	检查科目
复方双氯芬酸钠片	药物
多巴丝肼片	药物
腱反射亢进	症状
血压波动大	症状
全血细胞减少	症状
呼吸道感染	疾病
Rotor综合征	疾病
鼻窦鳞状细胞癌	疾病
肺弓形体病	疾病
婴儿睡觉出汗	症状
复方塞隆胶囊	药物
曲美他嗪	药物
类脂质蛋白沉积症	疾病
伪膜性肠炎	疾病
参芪颗粒	药物
成釉细胞纤维瘤	疾病
可乐定贴片	药物
枫香脂十味丸	药物
康胃素胶囊	药物
注射用重组人白细胞介素11	药物
妊娠时出现的多毛	症状
当归膏	药物
《不明原因发热的鉴别》	NoneType
青枝骨折	症状
头孢拉定分散片	药物
侧脑室增宽	症状
注射用亚锡聚合白蛋白	药物
结膜充血	症状
乌灵菌粉	NoneType
点头征	症状
至宝灵芝酒	NoneType
金刚烷胺	药物
健身长春颗粒	药物
舒肝顺气丸	药物
正柴胡饮颗粒	药物
习惯性髌骨脱位	疾病
刺歌雀	NoneType
食酸菌属	细菌
锁合	NoneType
煤炭工尘肺	疾病
丹红注射液	药物
磺胺吡啶	药物
前列泰片	药物
虚劳	疾病
冠状动脉异位起源	疾病
急性肾小管坏死	疾病
胃石形成	症状
感冒清热颗粒	药物
二巯基丙磺酸钠	药物
黄麻嗪胶丸	药物
消痔丸	药物
风湿塞隆胶囊	药物
三鞭补酒	药物
雷诺氏病	疾病
虎杖矾石搽剂	药物
止红肠辟丸	药物
活性炭	NoneType
汞溴红溶液	药物
炉甘石	NoneType
双相型体温	症状
厄多司坦片	药物
口咸	症状
羊藿益肾酒	药物
小儿吐泻宁	药物
乳腺内无痛单发的硬肿块	NoneType
持久性色素异常性红斑	疾病
联苯苄唑阴道片	药物
持续性枕横位难产	疾病
珠蛋白生成障碍性贫血视网膜病变	疾病
头孢地嗪钠	药物
延寿片	药物
以头昏为主的眩晕	症状
埃里希体病	疾病
耳源性脑脓肿	疾病
注射用香菇多糖	药物
参芝安神口服液	药物
膦甲酸钠葡萄糖注射液	药物
伴纤维囊性骨炎的假性甲状旁腺功能低下症	疾病
足底烧灼感	症状
无腋毛	症状
氨苄西林片	药物
腰肾膏	药物
脑血栓形成	疾病
直肠肛门内胀痛不适	症状
梅毒甲苯胺红不加热血清试验诊断试剂	药物
全血糖化Hb	检查科目
鼻渊舒口服液	药物
症状性癫痫综合征	疾病
老年人甲状腺功能亢进症	疾病
小儿原发性血小板增多症	疾病
头孢尼西	药物
盐酸尼卡地平缓释胶囊	药物
头皮感染	疾病
甲氨喋呤	NoneType
固本丸	药物
脾栓塞	症状
变性近视的脉络膜萎缩	疾病
芩连颗粒	药物
消化系癌伴血液病综合征	疾病
归脾颗粒	药物
醋氯芬酸片	药物
虎眼征	症状
免疫性溶血	症状
短波单胞菌属	细菌
老年跌倒	疾病
酚苄明	药物
盐酸去氧肾上腺素	药物
阿米巴性宫颈炎	疾病
泛发性毛囊错构瘤	疾病
对伞花烃胶丸	药物
门冬氨酸钙口服溶液	NoneType
磷酸咯萘啶注射液	药物
呼吸音粗糙	症状
上升岛链霉菌	细菌
哌甲酯	药物
安胎益母丸	药物
肝欣泰注射液	药物
甲氧苄氨嘧啶	药物
恶心	症状
扎普司特	药物
复方薄荷脑鼻用吸入剂	药物
硝酸异山梨酯喷雾剂	药物
肩周酸痛不适	症状
脂肪乳注射液	药物
莱葛颗粒	药物
癃闭	NoneType
黄藤素胶囊	药物
复方贝母片	药物
乳房肥大	症状
乳腺刺痛	症状
先天性主动脉瓣下狭窄	疾病
盆炎净片	药物
泮托拉唑	药物
白血生	药物
多维元素片	药物
植物血凝素	药物
溶血性黄疸	疾病
氨苄西林丙磺舒颗粒	药物
乳腺囊性增生病	疾病
肠道致病性大肠艾希氏菌诊断血清	NoneType
凝血酶原时间	NoneType
保儿安颗粒	药物
脑瘤	疾病
淋巴结-胆道综合征	疾病
阴道横隔	疾病
莫唑胺	药物
阿司匹林散	药物
白化病	疾病
那敏伪麻胶囊	药物
耳鸣	NoneType
醋酸甲地孕酮软胶囊	药物
重力休克	症状
口服补液盐I	药物
剥脱性皮炎	疾病
万灵五香膏	药物
小儿选择性免疫球蛋白G亚类缺陷病	药物
肾宝合剂	药物
角膜瘘	症状
恶性小汗腺汗孔瘤	疾病
胰腺假囊肿	疾病
小儿双唇综合征	疾病
粪便嵌塞	症状
小儿乳糜泻	疾病
脑外伤伴发的精神障碍	疾病
秋泻灵合剂	药物
金莲清热颗粒(无糖型)	NoneType
油性肉芽肿	疾病
尼索地平胶囊	药物
尿胃蛋白酶原	检查科目
黄体功能不全性不孕	疾病
溃得康颗粒	药物
上呼吸道和口腔存在大量定植菌	症状
地骨降糖胶囊	药物
止咳桃花散	药物
盐酸奥昔布宁片	药物
次没食子酸铋	NoneType
胃黏膜充血水肿	症状
急性下肢缺血	症状
实喘	疾病
马钱子散	药物
唇红干燥	症状
噻苯达唑	药物
润肺止咳合剂	药物
诺卡放线菌病	疾病
会阴疝	疾病
鳞状牙源性瘤	疾病
碘化钠	药物
良性颅内高压症	疾病
妇女咳嗽性遗尿	疾病
连翘四味汤散	药物
聚维酮碘	NoneType
更衣片	药物
去大脑强直	症状
口周湿疹	疾病
髂骨取骨后盆侧腹壁疝	疾病
海蛇天麻酒	NoneType
白连止痢胶囊	药物
复方丹参丸	药物
黄色结节	症状
凸甲	症状
强肾片	药物
咽肌麻痹	疾病
消咳喘片	药物
累及整个腹腔的腹膜炎	疾病
伊维菌素胶囊	药物
麦迪霉素胶囊	药物
约氏乳杆菌	细菌
先天性喉裂	疾病
天麻首乌胶囊	药物
甲基多巴	药物
摩氏变形菌	NoneType
麻仁润肠软胶囊	药物
复方西咪替丁胶囊	药物
长头畸形	NoneType
劳拉西泮片	药物
新生儿贫血	症状
紫草油	药物
头孢哌酮钠	药物
胸腹水纤维蛋白降解产物	检查科目
流行性肌痛	症状
钙沉积	症状
拉呋替丁片	药物
右雷佐生	药物
浓缩水牛角片	药物
眼球后退综合征	疾病
氯氧喹胶囊	药物
吸吮反射消失	症状
促胰酶素	药物
足部震颤	症状
丙美卡因	药物
胎产金丸	药物
盐酸氯哌丁片	药物
齐多拉米双夫定片	药物
酒石酸美托洛尔注射液	药物
肤胀	疾病
盐酸多奈哌齐	药物
戊己丸	药物
慢性扁桃体炎	疾病
满金止咳片	药物
梅毒螺旋体抗体诊断试剂盒(胶体金法)	药物
铜绿假单胞菌感染	症状
虎标万金油	药物
复方益肝丸	药物
甲硝唑氯化钠注射液	药物
人参败毒胶囊	药物
甲氧沙林片	药物
醋酸	药物
原发性单克隆球蛋白病肾损害	药物
视网膜静脉周围炎	疾病
人参糖肽注射液	药物
头孢丙烯分散片	药物
浓氯化钠溶液	药物
心脏畸形	症状
珍熊胆丸	药物
子宫癌	疾病
厄他培南	药物
益寿强身膏	药物
脑脊液单克隆抗体检测癌细胞	NoneType
司可巴比妥钠胶囊	药物
替硝唑阴道泡腾片	药物
巨噬细胞移动抑制试验	检查科目
滴虫性外阴炎	疾病
先天性喉软骨畸形	疾病
明藿降脂颗粒	药物
氯哌斯汀	药物
子宫附件肿块	症状
足跟蓝黑色或黑色斑点	NoneType
尼伐地平	药物
泌尿生殖系阿米巴病	疾病
小儿多发性肾小管功能障碍综合征	疾病
主动脉弓综合征视网膜病变	疾病
一滴香	NoneType
盐酸非那吡啶胶囊	药物
参仙片	药物
盐酸金刚乙胺颗粒	药物
氟氯西林钠颗粒	药物
盐酸可乐定注射液	药物
盐酸伊托必利	药物
乙酰乌头碱片	药物
急性肾小球肾炎	疾病
纹状体黑质变性	疾病
对乙酰氨基酚胶囊	药物
氢溴酸右美沙芬颗粒	药物
披碱草柄锈菌	NoneType
灵源万应茶	药物
羊水细胞培养染色体检查	检查科目
结节性脂肪坏死	疾病
亚叶酸钙注射液	药物
吗啡诊断试剂(胶体金法)	NoneType
注射用乳酸左氧氟沙星	药物
妊娠期急性脂肪肝	疾病
扁平苔癣	疾病
前牙深覆盖	疾病
脂肪肝	疾病
克霉唑尿素乳膏	药物
鼠咬伤	疾病
阿咖酚片	药物
除湿止痒软膏	药物
色厥色脱	疾病
清脑复神液	药物
腰背刺痛	症状
盐酸安普乐定	药物
构音不良-手笨拙综合征	疾病
鼠李糖乳杆菌	NoneType
甘草甜素片	药物
冠状病毒感染	疾病
十全大补酒	药物
尿血栓素B2	NoneType
扫日劳清肺止咳胶囊	药物
坐骨大小孔区出现压痛	症状
钩虫皮炎	疾病
氢溴酸苯甲托品片	药物
冻干乙型肝炎病毒表面抗原诊断血球	NoneType
变青褶孔菌	NoneType
颈静脉球瘤	疾病
血栓闭塞性脉管炎	疾病
注射用甘草酸二铵	药物
子宫松弛	症状
健儿膏	药物
血吸虫尾蚴性皮炎	疾病
盐酸奥布卡因滴眼液	药物
B因子	检查科目
肾痈	疾病
加速性室性自主心律	疾病
慈航片	药物
前额针刺样痛或烧灼感	症状
结肠膨胀	症状
维生素A摄入过多	NoneType
托洛沙酮	药物
碘克沙醇	药物
菊明降压丸	药物
小儿锁骨颅骨发育不全综合征	疾病
甘氨酰脯氨酸二肽氨基肽酶	检查科目
胃壁僵硬	症状
硫酸氨基葡萄糖氯化钾胶囊	药物
创伤	NoneType
益肾康胶囊	药物
冠通片	药物
种植性结节	症状
阴道血管肉瘤	疾病
胆热	疾病
食欲减退	症状
复方电解质葡萄糖注射液M3B	药物
菊蓝抗流感胶囊	药物
先天性外展性髋挛缩	疾病
同向偏盲	症状
祛伤消肿酊	药物
肝悦片	药物
小脑体征	症状
局方至宝丸	药物
碘酸钾颗粒	药物
多发梗塞性痴呆	疾病
硫酸小诺霉素滴眼液	NoneType
附睾畸形	疾病
治咳川贝枇杷露	药物
百部酊	药物
精制海马追风膏	药物
尿道弥漫性浸润	症状
小儿结核性胸膜炎	疾病
血脉通胶囊	药物
清咽丸	药物
脊髓性肌萎缩	症状
气道高反应性	症状
漆疮	疾病
气性坏疽病	疾病
脊髓压迫症	疾病
生肌八宝散	药物
阿呋唑嗪	药物
蜡样芽孢杆菌	NoneType
叶绿素铜钠胶囊	药物
丹曲林	药物
噻洛芬酸	药物
尿路结石	NoneType
左西替利嗪	药物
面部皮肤油腻	症状
甘氨酰酪氨酸	NoneType
参梅养胃颗粒	药物
氟芬那酸丁酯	药物
儿感退热宁口服液	药物
特发性大网膜节段性梗死	疾病
妊娠合并硬皮病	疾病
抽动症	疾病
开胃山楂丸	药物
胸椎畸形	症状
肠管变形	症状
尿素清除率(UCL)	检查科目
肾无功能	症状
雷佐生	药物
麝香回阳膏	药物
氨基酸螯合钙	药物
尿毒灵软膏	药物
抗脑衰胶囊	药物
猴头健胃灵胶囊	药物
盐酸米托蒽醌注射液	药物
儿童偏食	症状
八宝瑞生丸	药物
天参胶囊	药物
阿昔洛韦软膏	药物
双链酶皮内试验	检查科目
十味降糖颗粒	药物
布洛伪麻软胶囊	药物
小儿便秘	疾病
扭转痉挛	疾病
维生素B12溶液	药物
脑衰弱综合征	症状
流行性出血热	疾病
胰高血糖素瘤	疾病
慢性盆腔痛	症状
乳酸菌素咀嚼片	药物
病理性REM睡眠	症状
对乙酰氨基酚	药物
子痫症状	症状
鼻瓣区狭窄	疾病
排尿时外阴灼热、瘙痒或疼痛	NoneType
轻瘫	症状
注射用依托泊苷	药物
养阴清肺膏	药物
注射用头孢哌酮钠他唑巴坦钠	药物
西咪替丁注射液	药物
耳道划伤	症状
冬季皮肤瘙痒	症状
再造生血片	药物
巨细胞病毒感染	疾病
硝酸益康唑癣药水	药物
二氧化碳	NoneType
缩合葡萄糖氯化钠注射液	药物
阳盛体质	症状
髋部酸胀不适	症状
小儿呼吸衰竭	疾病
轮状病毒酶标诊断试剂盒	药物
小儿风热清口服液	药物
鼻炎宁胶囊	药物
三甲沙林	药物
诺氟沙星胶囊	药物
呼吸性碱中毒	疾病
运动或情绪激动诱发的胸痛	症状
红花跌打丸	药物
维生素A注射液	药物
面颈部毛囊性红斑黑变病	疾病
口、眼、生殖器损害	症状
尿道缺如及先天性尿道闭锁	疾病
三两半药酒	药物
小儿退热合剂	药物
颈通颗粒	药物
情感性交叉擦腿症	疾病
小儿智力糖浆	药物
参杞颗粒	药物
脊髓内脓肿	疾病
盐酸左西替利嗪	药物
环磷腺苷注射液	药物
氨酚维C分散片	药物
尿C肽	检查科目
氯化钾缓释片	药物
卵巢无性细胞瘤	疾病
白酱感冒颗粒	药物
皮肤囊肿	疾病
老年人先天性心血管疾病	疾病
黄芪健胃膏	药物
精制五加皮酒	药物
扁平骨盆	症状
田七花叶颗粒	药物
青春期后无精液	症状
凝血酶消耗试验	检查科目
低分子量肝素钠	药物
补肾益寿胶囊	药物
那可丁	药物
非洛地平缓释片	药物
麦芽片	药物
盐酸地美索酯片	药物
心包炎	疾病
对氨马尿酸清除率	检查科目
直肠癌	疾病
氨基酸尿症	疾病
银花口服液	药物
中枢神经兴奋药中毒	疾病
吡拉西坦	NoneType
四维葡锌胶丸	药物
注射用甘氨双唑钠	药物
纸样胎儿	症状
肋骨痛	症状
葡萄糖	NoneType
盐酸阿莫罗芬搽剂	药物
血清白细胞介素8	检查科目
钝痛	症状
小儿氨酚烷胺颗粒	药物
骨化二醇	NoneType
疗癣卡西甫散	药物
高甘油三酯血症	疾病
青光眼睫状体炎综合征	疾病
复方荆芥熏洗剂	药物
苯酚伪麻片	药物
肝内形成嗜酸性肉芽肿	症状
食管化学性烧伤	疾病
东梅止咳颗粒	药物
青霉素钠	药物
雷丸胶囊	药物
依替卡因	药物
甲状腺炎	疾病
小儿结核性脑膜炎	疾病
骨骼停止发育	症状
小儿无脾综合征	疾病
良性纤维组织细胞瘤	疾病
雪上一枝蒿片	药物
丹七软胶囊	药物
副球菌	NoneType
麝香风湿片	药物
复方阿司匹林牛磺酸胶囊	药物
小儿软骨营养障碍-血管瘤综合征	疾病
小脑定向力和功能障碍	NoneType
粪便硬结如羊粪状	症状
阵发性狂笑	症状
特发性青春期延迟	疾病
西帕依麦孜彼子口服液	药物
内消瘰疠丸	药物
坚硬芽孢杆菌	NoneType
虚热口臭	症状
加味银翘片	药物
肋骨骨折	疾病
六维胶丸	药物
新生儿便秘	NoneType
Ⅰ型超敏反应性疾病	疾病
冠心丸	药物
舒林酸	药物
脊髓空洞症	疾病
十香暖脐膏	药物
缺凝血因子IX血浆	NoneType
愈创甘油醚片	药物
天蟾胶囊	药物
五虎散	药物
风湿性舞蹈病	疾病
铜中毒引起的溶血性贫血	疾病
金感欣片	药物
硫酸鱼精蛋白	药物
鸟肠球菌	NoneType
脊柱脊髓损伤	疾病
胸膈间烧灼嘈杂感	NoneType
润肠丸	药物
小儿感染性心内膜炎	疾病
夏桑菊冲剂	药物
遗传性硬化性皮肤异色症	疾病
乙胺吡嗪利福异烟片	药物
颈部水囊瘤	疾病
景天祛斑胶囊	药物
蒲公英胶囊	药物
参芪肝康胶囊	药物
距骨骨折	疾病
腹腔室隔综合征	疾病
复方木香铝镁片	药物
手势性自动症	疾病
氧氟沙星片	药物
石胆酸	检查科目
注射用福莫司汀	药物
咪喹莫特	药物
环氧乙烷	药物
肺纹理增多	症状
亮菌甲素注射液	药物
弓形体感染	症状
万应颗粒	药物
香连化滞丸	药物
消旋卡多曲	药物
勤奋生金球菌	NoneType
注射用盐酸克林霉素	药物
敌鼠中毒	疾病
尿TH糖蛋白	NoneType
阴道粘连	症状
香果健消胶囊	药物
环氧司坦	药物
肝脏外伤	疾病
沉香化气片	药物
便通胶囊	药物
鲜红掌	NoneType
脓疱疮	疾病
赖诺普利胶囊	药物
芙蓉抗流感片	药物
了哥王颗粒	药物
猴痘	疾病
米帕林	药物
乌司他丁注射液	药物
乙型肝炎病毒表面抗原诊断试剂盒(胶体金法)	药物
盐酸达克罗宁胶浆	药物
神经症性反应	症状
急性坏死溃疡性龈炎	疾病
前列地尔注射液	药物
尿孕酮	药物
复方莪术油栓	药物
生力雄丸	药物
迷走神经损伤	疾病
阿奇霉素颗粒剂	药物
光化性角化病	疾病
上腹部肿块及腹胀	症状
跌打风湿药酒	药物
普美孕酮	药物
胃复春片	药物
心排血量增多	NoneType
流行性感冒亚单位疫苗	药物
尿促性素	药物
单侧及假性手足徐动	症状
芩翘口服液	药物
周氏回生丸	药物
异甘草酸镁	药物
藏毛窦和藏毛囊肿	疾病
十全大补片	药物
视野缩小	症状
直肠闭锁	疾病
先天性无阴道	疾病
宫颈癌片	药物
慢性淋巴细胞性甲状腺炎	疾病
小儿淋巴样息肉	疾病
硬化萎缩苔藓	疾病
气单胞菌	NoneType
恶性小汗腺螺旋腺瘤	疾病
参茸补肾片	药物
复方苦参水杨酸散	药物
红细胞表面电荷	检查科目
盐酸班布特罗胶囊	药物
对乙酰氨基酚颗粒剂	药物
风疹病毒抗体IgG	检查科目
血清酸性磷酸酶	NoneType
小儿葫芦散	药物
眼底黄斑部的樱桃红斑点	症状
老年人肺气肿	疾病
新生儿晚期代谢性酸中毒	疾病
断血流颗粒	药物
小儿缺铁性贫血	疾病
盐酸恩丹西酮	药物
羟苯丙胺	药物
书写痉挛	NoneType
骨刺丸	药物
感冒喷雾剂	药物
心脏刺痛	症状
绝经期乳腺癌	疾病
颈椎椎节已有明显退行性变	症状
消症扶正口服液	药物
儿童睡眠障碍	疾病
木瓜酒	药物
鼻鼽	疾病
生化丸	药物
反复发作的带状疱疹	症状
肾嗜酸细胞瘤	疾病
利膈丸	药物
营养性皮肤改变	症状
牛黄十三味丸	药物
喷司他丁	药物
盐酸奥昔布宁缓释片	药物
小儿烹调综合征	疾病
琥珀抱龙胶囊	药物
肛窦炎及肛乳头炎	疾病
复方氨敏虎杖胶囊	药物
十味蒂达胶囊	药物
闭眼站立不能	症状
面颈部化脓性淋巴结炎	疾病
氨苯砜	药物
玻璃体内可见球形囊体	症状
鼓膜外伤	疾病
北芪片	药物
跌打七厘片	药物
复肝康冲剂	药物
六味地黄颗粒	药物
桡神经损伤	疾病
脊神经根炎	疾病
斜视	NoneType
妇科千金胶囊	药物
调中四消丸	药物
温经活血片	药物
先天性耳聋	疾病
新生儿脐炎	疾病
痛风定胶囊	药物
盐酸西替利嗪口服溶液	药物
原发性渗出性淋巴瘤	疾病
男性青春期乳房发育	疾病
强直性脊柱炎及其伴发的葡萄膜炎	疾病
芪胶升白胶囊	药物
胎势异常	症状
单心室	疾病
羌虫病	疾病
呋塞米	NoneType
高血糖素	药物
雷尼替丁枸橼酸铋	药物
复方利血平氢氯噻嗪片	药物
感冒退热口服液	药物
泌石通胶囊	药物
甘氨茶碱钠	药物
吲哚美辛法呢酯	药物
布洛芬	NoneType
五味甘露药浴汤散	药物
额叶癫痫的扣带回发作	症状
薄荷六一散	药物
龙蛾酒	药物
扑粉	药物
血液呈现浓缩	症状
神曲茶	药物
颈椎病	疾病
皮肤黏蛋白沉积	症状
手皮肤发紫	症状
月劳病	疾病
经期肿胀	症状
当归补血冲剂	药物
胎盘血液灌注不良	症状
舒张期奔马律	症状
复方鱼肝油氧化锌软膏	药物
羚羊感冒片	药物
妇洁搽剂	药物
养血当归糖浆	药物
萘磺酸右丙氧芬	药物
埃罗替尼	药物
新生儿缺氧缺血性脑病	疾病
蠲痹抗生丸	药物
鼻外部膨胀隆起	症状
舌咬伤	症状
中风回春胶囊	药物
灿烂弧菌	细菌
赤白游风	疾病
辣根过氧化物酶标记免疫球蛋白结合物	药物
朗格汉斯细胞组织细胞增生症	疾病
结节性痒疹	疾病
颅脑创伤伴发的精神障碍	疾病
异位性皮炎	疾病
甘草甜味素散	药物
血速升颗粒	药物
百咳宁颗粒	药物
粪样呕吐物	症状
蓝芩口服液	药物
镇静、麻醉剂所致昏迷	NoneType
稀戊二醛溶液	药物
安乃近滴剂	药物
甲磺酸培氟沙星软膏	药物
舒胆片	药物
前列泰颗粒	药物
猜疑	症状
乳房神经纤维瘤	疾病
舌骨骨折	疾病
中毒性弱视	疾病
咳宁颗粒	药物
灯台叶颗粒	药物
无能力感	症状
气血康口服液	药物
藤黄健骨丸	药物
化学品测试合格实验室	NoneType
颈丛神经卡压症	疾病
帕司烟肼	药物
痰液中分泌型IgA	检查科目
孕酮放免药盒	药物
皖贝母	NoneType
肝龙胶囊	药物
奥古蛋白	药物
重瞳	疾病
支气管源性囊肿	疾病
双氯芬酸钠气雾剂	药物
腺病毒抗体	检查科目
急性左侧心力衰竭	疾病
高颅压性脑积水	疾病
注射用甲磺酸加贝酯	药物
嗜盐碱球菌	NoneType
燥邪犯肺	疾病
二氟尼柳胶囊	药物
金莲花冲剂	药物
腹腔感染	症状
安岛信天翁	NoneType
嗜水气单胞菌嗜水亚种	NoneType
肺阴虚	症状
紫斑	症状
天麻片	药物
遗传性蛋白C缺陷症	疾病
胃神经纤维瘤	疾病
千金藤碱	药物
聚明胶肽注射液	药物
厄贝沙坦	NoneType
脉络膜炎	疾病
复方地芬诺酯	药物
牛黄清热散	药物
外伤性脑膜炎	疾病
足舟状骨骨软骨病	疾病
聚乙二醇4000散	药物
食管憩室	疾病
类风湿性关节炎的肾损害	疾病
福寿胶囊	药物
茵栀益肝颗粒	药物
低眼压性青光眼	疾病
山药丸	药物
盐酸胺碘酮胶囊	药物
镁缺乏症	疾病
癃清胶囊	药物
叶酸缺乏症	疾病
通舒口爽胶囊	药物
红细胞变形性	检查科目
厄贝沙坦片	药物
清热感冒冲剂	药物
长膜壳绦虫病	疾病
米格来宁片	药物
桃红清血丸	药物
食毛后导致的胃肠道症状	NoneType
碳酸氢钠注射液	药物
外伤性癫痫	疾病
低分子羟乙基淀粉	药物
小儿加压素分泌过多综合征	疾病
小儿小颌畸形综合征	疾病
培西洛星	药物
血证	疾病
脑脊液丙二醛	检查科目
老年人肺结核病	疾病
脐湿	症状
养心安神丸	药物
Tigecycline	药物
银密片	药物
肾小管重吸收障碍	症状
包涵体肌炎与遗传性包涵体肌病	疾病
流行性甲型脑炎	疾病
斑蝥酸钠片	药物
蛤蚧定喘丸	药物
化脓性指头炎	疾病
老年人垂体瘤	疾病
石龙清血颗粒	药物
畏光	症状
食管壁纤维化	症状
基础胃液分泌量	NoneType
龙珠软膏	药物
丁溴东莨菪碱胶囊	药物
晕动病	疾病
热带性口炎性腹泻	疾病
寻常狼疮	疾病
皮肤有压痕	症状
血脂灵胶囊	药物
神经衰弱	NoneType
普鲁卡因胺	药物
博性康药膜	药物
胆石	NoneType
减压病	疾病
灰泥角化病	疾病
肝紫癜病	疾病
胃切除后胆汁返流性胃炎	疾病
复方肾病用氨基酸	药物
鼻泪管阻塞	症状
十味手参散	药物
肌张力减低	症状
宫颈肥大	NoneType
独一味咀嚼片	药物
右酮洛芬	药物
蕲蛇酶	药物
百树真油	NoneType
胶冻状便	症状
抗风湿液	NoneType
乳头湿疹	症状
密苏里游动放线菌	NoneType
巨大芽胞杆菌	细菌
肾虚腰痛	疾病
慢咽宁袋泡茶	药物
补脑安神片	药物
大观霉素	药物
复方黄莲素片	药物
淋病合并症精囊炎	疾病
肛管直肠周围脓肿	疾病
五苓胶囊	药物
真菌性食物中毒	疾病
金不换膏	药物
小儿清热灵	药物
盐酸拉贝洛尔	药物
淋巴管淤积	症状
慢支紫红丸	药物
抬肩以助呼吸	症状
发作性眩晕	症状
众生胶囊	药物
盐酸特比萘芬溶液	药物
聚乙烯醇滴眼液	药物
黄芩	药物
注射用双半胱氨酸	药物
柯莱斯骨折	疾病
虚脱	症状
醛固酮缺乏症	疾病
小儿成人型慢性粒细胞白血病	疾病
保婴镇惊丸	药物
新生儿溶血病	疾病
葡萄糖酸镁	药物
桔梗八味颗粒	药物
利福霉素钠	药物
马来酸溴苯那敏	药物
不全流产	症状
门静脉积气	症状
急性减压性骨坏死	疾病
肝肺综合症	疾病
鸡胸	疾病
胃太平胶囊	药物
妇炎康复咀嚼片	药物
剥夺性弱视	症状
后发性白内障	疾病
冠心安滴丸	药物
杏苏止咳糖浆	药物
鼠疫菌诊断用噬菌体	病毒
老范志万应神曲	NoneType
仁青常觉	药物
卵巢环管状性索肿瘤	疾病
戊型肝炎病毒抗体(IgG)诊断试剂盒(酶联免疫法)	药物
拇指不明原因疼痛	症状
溴丙胺太林片	药物
骶骨处持续性疼痛	症状
盐酸贝尼地平	药物
温虐	疾病
盐酸吡格列酮分散片	药物
精囊炎	疾病
牙齿上白垩色到褐色的斑块	症状
萘普生钠氯化钠注射液	药物
醋酸奥曲肽注射液	药物
海蛤散	药物
五味黄连丸	药物
妊娠合并白血病	疾病
头孢克洛咀嚼片	药物
盐酸氮卓斯汀	药物
仙方活命片	药物
氧化锌油	药物
硫酸庆大霉素肠溶片	药物
鼻咽清毒剂	药物
骨血管瘤	疾病
老年人肺炎	疾病
新雪丹	药物
小儿七星茶口服液	药物
感冒炎咳灵片	药物
盐酸屈他维林片	药物
盐酸氟西汀	药物
眼球垂直运动障碍	NoneType
盐酸伐昔洛韦片	药物
舞蹈样步态	症状
脾功能亢进	NoneType
雌二醇凝胶	药物
盐酸班布特罗颗粒	药物
头发淡黄色	症状
注射用顺苯磺阿曲库铵	药物
帕利珠单抗	药物
体循环淤血	症状
盐酸地拉卓片	药物
恐缩症	疾病
硫酸卷曲霉素	NoneType
固本益肠片	药物
外阴佩吉特病	疾病
天然胡萝卜素胶丸	药物
先天性肺囊肿	疾病
腹壁红斑	症状
风湿寒痛片	药物
腰软不能直起	症状
布洛芬滴剂	药物
法布里病	疾病
对氨基水杨酸钠片	药物
青霉病	疾病
枸橼酸乙胺嗪片	药物
坎地沙坦	药物
复方氢溴酸右美沙芬糖浆	药物
十全大补糖浆	药物
急性腹痛	症状
口底多间隙感染	疾病
康艾注射液	药物
参鹿补片	药物
肢端凉	症状
复方川贝止咳糖浆	药物
左旋甲状腺素钠片	药物
四味通络胶囊	药物
舒筋定痛酒	药物
六味地黄滴丸	药物
珍珠粉胶囊	药物
注射用盐酸地尔硫	药物
双眼上斜肌麻痹	疾病
妇宁胶囊	药物
法洛三联症	疾病
安眠酮片	药物
健脾益肾冲剂	药物
脾疳	疾病
乳酸菌素片	药物
复方益母胶囊	药物
小儿血小板释放功能缺陷性疾患	疾病
小儿人类细小病毒B19感染	疾病
胰腺外伤	疾病
绿雪胶囊	药物
顺行性遗忘	症状
苯甲酸利扎曲普坦片	药物
淋巴管瘤	疾病
早萌	疾病
哮喘丸	药物
格列齐特胶囊	药物
小儿晚发性维生素K缺乏病	疾病
外阴纤维肉瘤	疾病
痔康舒口服液	药物
盐酸丙米嗪片	药物
艾叶油软胶囊	药物
聚山梨酯80	药物
齿龈出血	症状
长城感冒片	药物
水痘	疾病
老年人高脂血症	疾病
卡比马唑片	药物
先天性跖骨内收畸形	疾病
青年心肌梗死	疾病
复方十一烯酸锌软膏	药物
苍鹅鼻炎片	药物
八味三香散	药物
苦参素软胶囊	药物
乙肝表面抗体（抗HBs）阳性	NoneType
胃苏颗粒(无糖型)	药物
复方联苯双酯颗粒	药物
脐周脓性分泌物较多	症状
癫痫性人格改变	症状
小儿衣原体肺炎	疾病
急性泪腺炎	疾病
泻痢固肠丸	药物
颈椎退化	症状
异物肉芽肿	疾病
复方紫荆皮水杨酸溶液	药物
长脉	症状
南非分枝杆菌	NoneType
风湿性心脏病	疾病
玻璃体混浊	疾病
肾绞痛	NoneType
灭菌枸橼酸钠	药物
促黄体激素(LH)胶体金试纸条	NoneType
制霉素	药物
利巴韦林滴眼液	药物
眼眶肌炎	疾病
特非那丁胶囊	药物
眼球穿孔	症状
会阴下降综合征	疾病
穿王消炎片	药物
运动时膝前疼痛加剧	症状
盐酸司来吉兰胶囊	药物
低钾血症肾病	疾病
全身过敏反应	症状
小儿海蓝组织细胞增生症	疾病
磺胺甲氧嗪	药物
羟基脲胶囊	药物
眉间皱纹	症状
聚乙烯醇	药物
盐酸林可霉素口服溶液	药物
乙硫异烟胺	药物
皮肤水疱，后形成黑色干痂	NoneType
雌酮硫酸酯哌嗪片	药物
药物性皮炎	疾病
香连丸浓缩丸	药物
陆英片	药物
记忆障碍	NoneType
小儿流口水	NoneType
磷酸苯丙哌林	NoneType
六味五灵片	药物
龟甲胶颗粒	药物
淋巴水肿	疾病
葡萄糖酸钙	NoneType
青果丸	药物
卵巢肿瘤破裂	疾病
叶下珠片	药物
真菌性脑膜炎	疾病
老年人上消化道出血	疾病
磷霉素	药物
过劳	症状
藏茵陈片	药物
耳部恶性肿瘤	疾病
风热感冒冲剂	药物
参麝活络丸	药物
髌下疼痛	症状
巨痕症	疾病
小儿进食片	药物
胆管癌	疾病
角膜擦伤	疾病
可可碱	药物
小儿血清病	疾病
复方甲苯咪唑	药物
阑尾类癌	疾病
百宝丹	药物
复方氯唑沙宗胶囊	药物
健脾补血冲剂	药物
假痛风性关节炎	疾病
颅内感染	NoneType
巴雷特食管	疾病
先天性心脏传导	症状
高尿酸血症	疾病
积液纤维结合蛋白	检查科目
舒络片	药物
载脂蛋白A	NoneType
人酸性铁蛋白	检查科目
抗病毒口服液	药物
利福平胶囊	药物
愈美胶囊	药物
胃肠舒胶囊	药物
慢性腰痛伴下肢麻痛	症状
消痔软膏	药物
盐酸普鲁卡因	药物
晚期先天性梅毒	疾病
清热化毒丸	药物
性厌恶	疾病
氯噻酮	药物
新凝灵	药物
血清精氨酸酶	检查科目
解毒万灵丸	药物
嗜皮菌病	疾病
脑实质的浸润	症状
养阴生血合剂	药物
硫酸氨基葡萄糖片	药物
清金止嗽化痰丸	药物
参杞片	药物
儿童急性良性肌炎	疾病
鼻煽	症状
细菌感染	疾病
骨质磨损有骨赘增生	症状
阴虚火亢症	疾病
假性醛固酮减少症	疾病
头-面血管瘤综合征	疾病
烟酸占替诺	NoneType
肾动脉栓塞	疾病
九味沉香胶囊	药物
成人T细胞白血病	疾病
镇银膏	药物
虚寒咳嗽	疾病
胰头癌	疾病
软组织肉瘤	疾病
异帕米星	药物
新型狗皮膏	药物
离位皮炎	疾病
粥样泻	症状
注射用哌拉西林钠他唑巴坦钠	药物
合并马蹄肾的腹主动脉瘤	疾病
婴儿保肺宁	药物
垂体性矮小病	疾病
网膜原发性节段性梗死	疾病
血浆蛋白检测试剂补体成份C5抗血清	药物
面肌无力	症状
外阴卵黄囊瘤	疾病
丙戊酸钠缓释片	药物
牙龈上发生黑线	症状
当归调经冲剂	药物
腺病毒感染	疾病
血复生胶囊	药物
雪山胃宝丸	药物
昏厥	症状
四肢淋巴水肿	疾病
愈肝片	药物
安眠补脑糖浆	药物
卧龙散	药物
小儿止嗽糖浆	药物
胸长神经卡压症	疾病
先天性支气管囊肿	疾病
单侧肾缺如	疾病
新金色分枝杆菌	NoneType
鞣酸蛋白酵母散	药物
银黄胶囊	药物
精液带血	症状
注射用白眉蛇毒血凝酶	药物
口淡黏腻	症状
低温性昏迷	症状
黄色发亮结痂	症状
氯哌噻吨	药物
胆舒	药物
扑美伪麻片	药物
维生素BT片	药物
新鱼腥草素钠	药物
陈香露白露片	药物
磺胺嘧啶混悬剂	药物
上海精神医学	NoneType
尿蛋白定量	检查科目
愈肝龙糖浆	药物
红霉素	NoneType
茴三硫片	药物
躯体形式疼痛障碍	症状
碘佛醇注射液	药物
小儿迪格奥尔格综合征	疾病
双足红肿热痛	症状
注射用双嘧达莫	药物
甲乙型肝炎联合疫苗	药物
三金胶囊	药物
头孢噻肟	药物
左心室腔容量增大	NoneType
盆腔炎性肿块	疾病
蓝芷安脑胶囊	药物
氧化再生纤维素	药物
便血且血与粪便混合	症状
脾气变坏	症状
十香定痛丸	药物
多源性房性心动过速	疾病
大七厘散	药物
通脉冲剂	药物
肾宁散胶囊	药物
清热解毒糖浆	药物
产褥感染	NoneType
腮腺宁糊剂	药物
小儿布洛芬栓	药物
眼疲劳	症状
注射用亮菌甲素	药物
地氯雷他定片	药物
泻毒散	药物
疗肺宁片	药物
咳喘顺丸	药物
脑得生颗粒	药物
阴道脓性分泌物	症状
牙齿小且无光泽	症状
红药贴膏	药物
妇宁康片	药物
微杆菌属	细菌
经前综合症	疾病
牛黄清胃丸	药物
多胎	NoneType
舒络养肝丸	药物
参蛤平喘胶囊	药物
长头巨脑	症状
巩膜穿孔	症状
尼可刹米	药物
盲肠肉芽肿	疾病
盐酸氮卓斯汀鼻喷雾剂	药物
枫蓼肠胃康合剂	药物
盐酸麻黄碱苯海拉明片	药物
葛根总黄酮	药物
血清不饱和铁结合力	检查科目
花翳自陷	NoneType
结缔组织性肠炎	疾病
米索前列醇片	药物
盐酸克林霉素葡萄糖注射液	药物
小青龙冲剂	药物
桑菊感冒片	药物
遗传性牙本质发育不全	疾病
毛圆线虫病	疾病
甲硝唑洗液	药物
四肢血压脉搏不对称	症状
三甲曲沙	药物
养胃宁胶囊	药物
小儿血管瘤血小板减少综合征	疾病
羟乙基淀粉	药物
小儿惊风七厘散	药物
高凝状态	症状
肘管综合征	疾病
耆鹿逐痹胶囊	药物
牛黄宁宫片	药物
氧化镁	NoneType
回生口服液	药物
卡莫氟片	药物
小儿鼻炎片	药物
十灰丸	药物
单硝酸异山梨酯片	药物
哈敦海鲁木勒十三味丸	药物
桂龙药膏	药物
水飞蓟素片	药物
对氨基水杨酸钠肠溶片	药物
黄瘤	疾病
总补体	NoneType
西吡氯铵	NoneType
慢肝解郁胶囊	药物
齿龈炎	疾病
矢状窦旁脑膜瘤	疾病
婴儿枕秃	症状
伊班膦酸钠	药物
注射用盐酸二甲弗林	药物
小儿复方磺胺嘧啶散	药物
磷酸哌嗪	药物
非那雄胺分散片	药物
多发性硬化伴发的葡萄膜炎	疾病
出血性脑梗死	疾病
止咳梨煎膏	药物
小儿导赤片	药物
乳酸菌素	药物
唇周边长痘	症状
小梁网色素沉着	症状
鼠神经生长因子	药物
丙磺舒片	药物
智能障碍	NoneType
人类免疫缺陷病毒HIV1/2型抗体诊断试剂乳胶层析法	NoneType
福辛普利钠	药物
绞股蓝总苷胶囊	药物
水合氯醛中毒	疾病
复方曲安奈德乳膏	药物
多巴酚丁胺	药物
血清蛋白结合碘	NoneType
月经前水肿	症状
复方八维甲睾酮胶囊	药物
疼痛性股白肿	症状
丙帕锗	药物
愈美缓释片	药物
酚麻美敏咀嚼片	药物
硫酸羟氯喹	药物
风寒止痛膏	药物
安吖啶注射液	药物
复方葡萄糖酸钙口服溶液	药物
盐酸舍曲林胶囊	药物
醋酸氟轻松乳膏	药物
奥西那林	药物
三磷酸腺苷二钠	药物
维生素C颗粒	药物
血清HDL-C水平减低	NoneType
慢性细菌性痢疾	疾病
野野村氏菌	NoneType
五加参归芪精	药物
嗜酸粒细胞增多症	疾病
泌尿系结石	NoneType
注射用异环磷酰胺	药物
尿分叉	症状
尼美舒利分散片	药物
七宝美髯丹	药物
息贲	疾病
蛛网膜增厚	症状
葡激酶	药物
眼外肌运动无力	症状
单克隆丙种球蛋白	药物
强身合剂	药物
龟鹿补肾口服液	药物
马牙	疾病
杞蓉片	药物
糖代谢紊乱	症状
肌肉砸伤	症状
银耳孢糖	药物
腿脚浮肿	症状
双扑口服液	药物
失眠	NoneType
杞菊地黄丸(浓缩丸)	药物
前列泰胶囊	药物
喷他佐辛	药物
穿心莲内酯滴丸	药物
银翘双解栓	NoneType
冠心丹参颗粒	药物
外伤性乳糜胸	疾病
洛莫司汀	药物
舍雷肽酶片	药物
精液果糖	检查科目
雷马曲班	药物
罗汉果止咳膏	药物
吲达帕胺滴丸	药物
姜冲剂	药物
养阴清肺丸	药物
补益资生丸	药物
醋酸甲羟孕酮复合胶囊	药物
血清单胺氧化酶同工酶	检查科目
糖原贮积病Ⅰ型	NoneType
胸主动脉夹层动脉瘤	疾病
萸连片	药物
粉防己碱	药物
颈部不稳感	症状
脊髓梗死	症状
乙酰唑胺片	药物
二至丸	药物
复方板蓝根片	药物
葡萄糖鱼肝油乳剂	药物
皮质素不足	症状
足底凸起	症状
非诺贝特胶囊	药物
银杏中毒	疾病
痔康片	药物
腺淋巴瘤	疾病
鼻孢子虫病	疾病
司他夫定胶囊	药物
溃疡灵胶囊	药物
龙线虫病	疾病
心理弹性	NoneType
矽肺宁片	药物
参桂理中丸	药物
脑脊液P物质	检查科目
咽部和喉部危象	症状
小儿厌食颗粒	药物
小儿消积止咳口服液	药物
调元大补二十五味汤散	药物
声带肥厚	NoneType
胰腺内钙化	症状
尿去氢异雄酮	药物
上肢呈迟缓性麻痹	症状
利福定胶囊	药物
心肌灰白而松弛	症状
清火栀麦胶囊	药物
枸橼酸喷托维林片	药物
睾丸片	药物
尿维生素B1	检查科目
尿锰粪锰	症状
创伤性血胸	疾病
疥疮	疾病
布美他尼注射液	药物
青少年牙周炎	疾病
脚气散	药物
银翘解毒丸	药物
阿片粉	药物
恶性高血压性小动脉性肾硬化	疾病
吸入性损伤	疾病
胆总管囊肿	疾病
复方双花口服液	药物
Zieve综合征	疾病
硫糖铝咀嚼片	药物
咽囊炎	疾病
心益好片	药物
近视乐眼药水	药物
乙肝健片	药物
腹壁挫伤	疾病
指甲失去光泽和平整状态变薄且脆出现白色横纹	症状
替诺昔康	药物
胫骨干骨不连	症状
注射用盐酸头孢吡肟	药物
脉络膜出血	疾病
急性肠系膜上动脉栓塞或血栓形成	疾病
伤湿宝珍膏	药物
白带净胶囊	药物
东方马型脑炎	疾病
复方土荆皮酊	药物
丹栀逍遥胶囊	药物
脐尿管囊肿及脐尿管瘘	疾病
妇宁栓	药物
剧痛	症状
小菜粉蝶颗粒体病毒 	NoneType
注射用盐酸头孢替安	药物
血外渗性囊肿	疾病
角膜后胚胎环	症状
法莫替丁注射液	药物
血脂平胶囊	药物
环噻嗪	药物
归脾丸	药物
倒地笑	症状
前列腺硬结	症状
混合型慢性高原病	疾病
多西他赛	药物
失用步态	症状
健儿素颗粒	药物
归芪口服液	药物
酒精中毒性偏执状态	症状
平消胶囊	药物
七消丸	药物
卡马西平缓释片	药物
萎缩纹	疾病
小儿宝泰康冲剂	药物
氨酚伪麻那敏胶囊	药物
子宫发育异常	疾病
小儿肾性尿崩症	疾病
皮肤冷而苍白粘腻	症状
杞菊地黄丸浓缩丸	药物
克林霉素甲硝唑搽剂	药物
精子活动力	NoneType
化脓性脑膜炎	疾病
头虱	NoneType
真菌性尿路感染	疾病
抗人球蛋白试验	药物
眼球穿孔伤	疾病
层状鱼鳞癣	疾病
近视	症状
榄香烯	药物
牙痛宁滴丸	药物
皮肤多痣	症状
盐酸地尔硫卓片	药物
弥漫性下腰痛	症状
喉头发紧	症状
皮下脂肪消失	症状
西咪替丁咀嚼片	药物
可卡因	药物
肾旋转异常	疾病
磷酸腺嘌呤片	药物
注射用硫酸卡那霉素	药物
重组牛碱性成纤维细胞生长因子外用凝胶	药物
幼年性黄色肉芽肿	疾病
长期使用糖皮质激素导致的损害	症状
神经根激惹症状	症状
脊柱破坏	症状
泪溢	症状
脉搏快而弱	症状
溃疡穿孔或出血	症状
接骨灵贴膏	药物
高血压性心脏病	疾病
卡苯达唑乳膏	药物
低血容量性休克	疾病
酒石酸吉他霉素	药物
难免流产或不可避免流产	症状
髋关节脱位	NoneType
小儿梅克尔憩室	疾病
二羟丙茶碱片	药物
健胃宽胸丸	药物
肛提肌综合征	疾病
腱鞘炎	疾病
风寒感冒颗粒剂	药物
硫酸新霉素	NoneType
屈髋屈膝及外旋畸形	症状
维生素B12吸收不良	症状
心跳过速	症状
小儿卡斯钦-贝克病	疾病
盐酸阿莫罗芬	药物
芙朴感冒胶囊	药物
硫马唑	药物
酚妥拉明	药物
杜仲药酒	NoneType
泪液乳铁蛋白	NoneType
嗜酒	NoneType
酒精性弱视	疾病
老年人消化性溃疡	疾病
萄醛内酯片	药物
四肢苔藓样变	症状
腹膜肿瘤	疾病
打嗝	症状
复方百部止咳颗粒	药物
清肺抑火片	药物
视网膜分支动脉阻塞	疾病
沙眼衣原体IgM和IgG	检查科目
无比山药丸	药物
半夏止咳糖浆	药物
中老年男子部分性雄激素缺乏综合征	疾病
槐耳颗粒	药物
番茄不孕病毒	病毒
小柴胡泡腾片	药物
蛋氨酸片	药物
牛奶色或米汤样便	症状
特发性胃肠道嗜酸性细胞浸润综合征	疾病
神经病性关节病	疾病
电击伤所致脊髓病	疾病
参芪消渴胶囊	药物
溃疡疼痛	症状
根癌土壤杆菌	NoneType
小儿慢性粒细胞白血病	疾病
继发性皮肤滤泡中心细胞性淋巴瘤	疾病
颈部呈僵直状	症状
酒精性肝硬化	疾病
盐酸吡格列酮片	药物
孢子丝菌凝集试验	检查科目
盐水球菌	NoneType
蜂窝肺	症状
产道扁平型狭窄	症状
后天性三尖瓣关闭不全	疾病
香菊感冒颗粒	药物
化瘀祛斑胶囊	药物
重组人5型腺病毒注射液	药物
口腔颌面部恶性黑素瘤	疾病
膦甲酸钠	药物
束臂试验阳性	NoneType
奥沙普秦肠溶片	药物
维生素D依赖性佝偻病	疾病
复方茶碱麻黄碱糖浆	药物
万灵筋骨膏	药物
清热镇惊散	药物
骨盆骨折	疾病
窦性期前收缩	疾病
复方甲基麻黄碱口服溶液	药物
硫酸延胡索乙素	NoneType
甘草酸单铵盐	NoneType
过氧化氢溶液	药物
青叶胆胶囊	药物
肝区血管杂音	症状
口炎颗粒	药物
下颌下隙感染	疾病
目痛	症状
绒毛膜癌	疾病
美法仑	药物
沃纳综合征	疾病
醋酸地塞米松软膏	药物
注射用盐酸昂丹司琼	药物
尿道分泌粘液或脓性分泌物	症状
伤风感冒颗粒	药物
洛度沙胺	药物
家族性结肠息肉	疾病
肾上腺素	NoneType
沙门氏菌属食物中毒	疾病
痧气	疾病
小儿肝素-血小板减少-血栓形成综合征	疾病
角膜灼伤刮伤	症状
氟罗沙星片	药物
硫酸钡(II型)干混悬剂	药物
跌伤灵贴膏	药物
盐酸普鲁卡因注射液	药物
盐酸哌唑嗪片	药物
眼眶内静脉曲张	疾病
血脂宁丸	药物
心脏内粘液瘤	疾病
咳嗽糖浆	药物
逍遥颗粒(无糖型)	NoneType
天麻素胶囊	药物
肺水肿	NoneType
中间葡萄膜炎	疾病
家族性载脂蛋白B100缺陷症	疾病
胸壁塌陷	症状
Ⅱ型免疫母细胞性淋巴腺病	疾病
酒石酸托特罗定胶囊	药物
维肝福泰片	药物
麝香心痛膏	药物
治痢片	药物
蒙脱石分散片	药物
口形红细胞	NoneType
小腿或前臂间隙综合征	症状
梦行症	疾病
桡管综合征	疾病
咯血伴有皮肤粘膜出血	症状
伴齿状突骨折的寰枢椎前脱位	疾病
强身健脑片	药物
小儿红白血病	疾病
小儿地方性克汀病	疾病
咽部狭窄及闭锁	疾病
动作样壁	症状
银杏叶口服液	药物
复方五指柑片	药物
血滞通胶囊	药物
金石感冒茶	药物
头孢羟氨苄胶囊	药物
复方联苯双酯片	药物
明目上清丸	药物
阿普唑仑	药物
血糖升高	症状
注射用转移因子	药物
牙齿拥挤错位排列不齐	NoneType
大麻隆	药物
膀胱颈挛缩	疾病
盐酸溴己新	药物
注射用葛根素	药物
益寿大补酒	NoneType
眼睑脓肿	症状
元胡止痛颗粒	药物
活络健身液	药物
抑肽酶氯化钠注射液	药物
眼科	医学专科
颈部血管瘤	疾病
听力下降	症状
田七痛经胶囊	药物
明癣	疾病
下垂肩	症状
三鞭温阳胶囊	药物
老年人食管裂孔疝	疾病
阴囊潮湿	疾病
生脓性肉芽肿	疾病
单发性毛鞘瘤	疾病
曲克芦丁氯化钠注射液	药物
神经鞘源性肿瘤	疾病
豆纹动脉闭塞	症状
脑脊液无机磷	检查科目
强肝丸	药物
脑蛛网膜下腔出血	疾病
品行障碍	疾病
颈内动脉创伤性血栓	症状
感染性肋软骨炎	疾病
枯草芽孢杆菌喷雾剂	药物
木糖醇片	药物
心脏失代偿	症状
支气管哮喘	疾病
碘糖丸	药物
青春前期闭经	症状
盐酸坦洛新缓释片	药物
小儿脂肪吸收不良	NoneType
女金丹丸	药物
小螺菌感染	疾病
豆腐果苷片	药物
镇心痛口服液	药物
睑结膜的巨大乳头	症状
附子理中丸(浓缩丸)	药物
左羟丙哌嗪分散片	药物
发育生物学	NoneType
肾小管细胞受损后炎症	疾病
桉柠蒎肠溶软胶囊	药物
五味健脑口服液	药物
中风回春丸	药物
脉搏短绌	症状
小儿氨基酸注射液	药物
吉培福林	药物
新生儿绿牙或棕褐色牙	症状
高钙血症	疾病
食欲不振	NoneType
鼻衄	NoneType
结膜干燥斑	症状
赖脯胰岛素	药物
甲磺酸培氟沙星注射液	药物
苯唑西林钠胶囊	药物
皮肤康洗液	药物
呼吸抑制	症状
夏季痒疹	症状
苯扎溴铵	NoneType
肢端湿冷	症状
进行性核上性麻痹	疾病
妊娠合并红细胞增多症	疾病
癌胚抗原免放药盒	药物
清热止痛三味汤散	药物
低血钾	NoneType
盐酸氨溴索缓释胶囊	药物
山楂降压丸	药物
胸膜毛细血管通透性增加	症状
芽生菌病样脓皮病	疾病
午时茶胶囊	药物
桑姜感冒片	药物
利胆片	药物
外阴象皮肿	疾病
皮肌炎	疾病
足	NoneType
小儿弹性假黄瘤	疾病
痰湿体质	症状
胰腺结核	疾病
二母宁嗽口服液	药物
尿氨氮	检查科目
盐酸乙胺丁醇胶囊	药物
金菊五花茶颗粒	药物
反复上呼吸道感染	症状
哮病	疾病
注射用盐酸普鲁卡因	药物
水杨酸苯佐卡因软膏	药物
疱疹性咽峡炎	疾病
鼓膜瘢痕化	症状
肺宫崎肺吸虫症	疾病
结核性淋巴结炎	疾病
注射用阿昔洛韦	药物
红曲提取物	药物
女科十珍丸	药物
注射用苦参碱	药物
头孢替坦	药物
直肠子宫内膜异位症	疾病
血清脂蛋X	检查科目
川芎茶调丸	药物
骨化二醇胶囊	药物
健胃愈疡颗粒	药物
过氧苯甲酰乳膏	药物
泪滴状红细胞	检查科目
结肠血管畸形	疾病
口腔颌面部软组织擦伤	疾病
依托泊苷注射液	药物
十味诃子汤散	药物
胰胆炎合剂	药物
阿归养血糖浆	药物
隐匿性肾小球肾炎	疾病
风热咳嗽丸	药物
变应性口炎	疾病
膀胱外翻	疾病
伸筋片	药物
黄精丸	药物
自身红细胞过敏性紫癜	疾病
椎体结核	症状
关节炎	疾病
注射用硫酸链霉素	药物
盐酸地美索酯	药物
奥沙唑仑	药物
脸冻伤	症状
躯体形式障碍	疾病
通便灵茶	药物
菠萝蛋白酶	NoneType
注射用高三尖杉酯碱	药物
西吡氯铵漱口液	NoneType
驻车丸	药物
肾上腺危象	疾病
小儿肺动脉高压	疾病
盐酸头孢替安	药物
蟾酥镇痛巴布膏	药物
硼砂	NoneType
盐酸莫雷西嗪	药物
巴戟振阳胶囊	药物
虹膜表面形成灰白色肿瘤结节	症状
维生素C钠	药物
阿克他利片	药物
清膈丸	药物
咽喉烧伤及化学伤	疾病
气滞胃痛颗粒	药物
消渴丸	药物
肤舒止痒膏	药物
丙酸氯倍他索搽剂	药物
手臂肌肉萎缩	症状
面部血管纤维瘤	疾病
乳疾灵颗粒	药物
抗宫炎胶囊	药物
胃慢性出血	症状
血管增生	症状
先天性铜代谢障碍	症状
黑尿	症状
踝关节疼痛	症状
液状甘油磷酸钠	药物
硫酸吗啡	药物
输尿管损伤	疾病
舒肝理气丸	药物
先天性腹壁发育不全	NoneType
清凉油(白色)	药物
金鱼眼	NoneType
抽筋	症状
血脂异常	疾病
先令氏指数	检查科目
参芪山药膏	药物
肌张力过高	症状
脑脊液肌酸激酶	检查科目
绞股蓝总苷片	药物
支气管结石	疾病
尿囊素	NoneType
新生儿两眼上翻凝视	症状
菌血症	疾病
泮托拉唑钠肠溶胶囊	药物
血痂	症状
眶假瘤	疾病
新生儿期癫痫持续状态	症状
注射用硫酸镁	药物
原发性免疫缺陷病	疾病
天王补心片	药物
麻风性周围神经病	疾病
棕榈氯霉素B型片	药物
曲古霉素	药物
产后肥胖	症状
喉部淋巴滤泡增生	症状
包皮过长	症状
盐酸洛哌丁胺	药物
美敏伪麻口服液	药物
异性装扮癖	NoneType
著痹	NoneType
铝碳酸镁颗粒	药物
胃肠道症状	症状
小儿脑血管畸形	疾病
依匹斯汀	药物
清肤止痒酊	药物
乌鸡养血糖浆	药物
老年性昏迷	疾病
淤胆型肝炎	疾病
琥珀利气丸	药物
利多卡因气雾剂	药物
重组葡激酶	药物
硫酸锌	NoneType
复方甲基麻黄碱口服液	药物
内分泌性高血压	疾病
心脏功能突然失代偿	NoneType
血脂康	药物
静脉曲张性外痔	症状
脐窝内有肉芽组织增生	症状
柴贯解热颗粒	药物
祛风湿药酒	NoneType
曲克芦丁香豆素片	药物
石椒草咳喘颗粒	药物
大黄散	药物
参苓健脾丸	药物
发热伴尿频、尿急、尿痛、腰疼	NoneType
罗格列酮钠	药物
复方地塞米松凝胶	药物
外展型骨折	症状
桂哌齐特	药物
乳酸杆菌	NoneType
牙瘤	疾病
凝血时间	检查科目
消朦片	药物
小儿热疮	疾病
手与手指胀满感	症状
小儿肺栓塞	疾病
气痢	疾病
胆囊壁纤维化	症状
秋燥	疾病
阿昔洛韦凝胶	药物
小儿大黄碳酸氢钠片	药物
五淋化石丸	药物
杜仲补天素片	药物
淀粉样变病	疾病
脑栓康复胶囊	药物
地高辛口服溶液	药物
头孢噻吩钠	药物
二水焦磷酸钙结晶沉积症	疾病
媚灵丸	药物
了哥王胶囊	药物
注射用硫普罗宁	药物
复方苦参洗剂	药物
参附强心丸	药物
右倍他米松磷酸钠	药物
小败毒膏	药物
腹直肌触及边界不清的固定包块	症状
归肾丸	药物
思虑伤脾	症状
腹股沟疼痛	症状
利巴韦林眼膏	药物
抗肌球蛋白抗体	检查科目
雷尼替丁	药物
氨来占诺	药物
葡萄糖酸钠	药物
卵巢早衰	疾病
高动力性循环	疾病
日晒斑	NoneType
多索茶碱片	药物
金黄抱龙丸	药物
双侧肾内痛	症状
和肝利胆颗粒	药物
武力拔寒散	药物
胡子稀疏	NoneType
利巴韦林含片	药物
注射用盐酸环丙沙星	药物
大腿内侧红斑	症状
脚后跟长骨刺	症状
伊来西胺	药物
鱼石脂	NoneType
迪厄拉富瓦病	疾病
包皮阴茎头炎	疾病
追风透骨丸	药物
毛舌	疾病
肌肉撞伤	症状
赤脉贯布	疾病
慢性进行性眼外肌麻痹	疾病
甲喹酮	药物
反社会人格障碍	疾病
状元丸	药物
免疫损害	症状
肝宁片	药物
阴道腺癌	疾病
二氢麦角碱	NoneType
妇炎平栓	药物
口渴感丧失	症状
盐酸伪麻黄碱	药物
盐酸克林霉素棕榈酸酯干混悬剂	药物
注射用玻璃酸酶	药物
六灵含片	药物
长春西汀葡萄糖注射液	药物
肝功能衰竭	NoneType
肺纤维化	疾病
酚磺乙胺	药物
氨酚伪麻美那敏片	药物
岔气	NoneType
复方青黛胶囊	药物
氟马西尼	药物
玉露保肺丸	药物
甲营养不良	疾病
生化妊娠	NoneType
六味能消胶囊	药物
皮肤冻伤	症状
复方扑炎痛	药物
复方磺胺嘧啶片	药物
皮下指头至鸽蛋大的肿块结节	症状
甲琥胺	药物
变异性哮喘	疾病
憩室出血	症状
复方阿米三嗪片	药物
太阳	NoneType
小儿定喘口服液	药物
淋巴丝虫病	疾病
豨莶丸	药物
产道裂伤	NoneType
下鼻甲或中鼻甲肥大	症状
阳虚体质	疾病
盐酸组氨酸	药物
清咽六味散	药物
眶上裂综合征	疾病
保胎无忧片	药物
愈酚甲麻那敏分散片	药物
舒心降脂片	药物
吡格列酮	药物
盐酸利多卡因注射液(溶剂用)	药物
固肠胶囊	药物
喉癌	疾病
多发性结节	症状
呼吸衰竭	疾病
粟丘疹	疾病
注射用盐酸多柔比星	药物
宁神定志丸	药物
苦黄注射液	药物
复方依那普利片	药物
特比奈芬	药物
急性肾功能不全	症状
皮肤肉芽肿	症状
复方咪康唑曲安奈德乳膏	药物
肝硬化	疾病
脑蛋白水解物氯化钠注射液	药物
宣肺止嗽合剂	药物
西司他丁	药物
髌骨骨裂	症状
假性动脉瘤	疾病
红霉素软膏	药物
上海市营养学会	NoneType
紫癜性肾炎	疾病
腰痛伴尿频、尿急、尿痛	NoneType
黄斑回避现象	症状
九分散	药物
肌苷注射液	药物
摩擦型性变态	NoneType
盐酸曲马多注射液	药物
活血健骨片	药物
夏枯草颗粒	药物
氢溴酸高乌甲素注射液	药物
胰酶肠溶片	药物
食管壁内憩室	疾病
头孢克洛片	药物
注射用盐酸托烷司琼	药物
趾间神经痛	疾病
言语中断	症状
继发性白血病	疾病
利口清含漱液	NoneType
脑动脉硬化伴发的精神障碍	疾病
胸锁乳突肌附着处压痛	症状
三子颗粒	药物
小儿触电与雷击	疾病
小牛血去蛋白提取物	药物
老年人终末期肺炎	疾病
金嗓散结丸	药物
口咽部粘连	疾病
急性气管支气管炎	疾病
沙美特罗	药物
麦粒肿	疾病
盐酸丙帕他莫	药物
沙眼衣原体核酸扩增(PCR)荧光检测试剂盒	药物
吲哚美辛控释片	药物
甲氨蝶呤片	药物
脑积水	NoneType
氨咖黄敏胶囊	药物
指甲呈扇形	症状
单侧肺气肿	NoneType
维生素AD软胶囊	药物
妊娠热病	疾病
小儿糖原贮积病Ⅴ型	NoneType
深海龙丸	药物
交沙霉素片	药物
维生素B2注射液	药物
中毒严重	症状
神经鞘瘤	疾病
梅毒甲苯胺红不加热血清试验诊断试剂盒	药物
气血康胶囊	药物
牙龈纤维瘤病	疾病
小儿视网膜色素变性-肥胖-多指综合征	疾病
珊瑚七十味丸	药物
寇热	疾病
皮下血肿	症状
痰净片	药物
音调韵律的异常	症状
甲基杆菌属	细菌
重复膀胱	疾病
硝酸毛果芸香碱注射液	药物
安神健脑液	药物
萘夫西林	药物
眼睑部有明显的刺痒感和烧灼感	症状
注射用前列地尔	药物
组织细胞坏死性淋巴结炎	疾病
妊娠试验	检查科目
交替单胞菌	NoneType
小儿军团病肾病	疾病
呋喃妥因	药物
脑脊液鼻漏	疾病
足部坏疽	症状
氯化铵片	药物
开胸顺气丸	药物
糖尿病型牙周炎	疾病
吸收性氧化纤维素	药物
刺五加脑灵胶囊	药物
三水杨酸胆碱镁	药物
氟氯西林	药物
止血片	药物
注射用过氧化碳酰胺	药物
脑桥中央髓鞘溶解症	疾病
湛江蟾蜍膏	药物
独一味胶囊	药物
下肢振动觉和位置觉受损	症状
大蒜素葡萄糖注射液	药物
蒲地蓝消炎胶囊	药物
子宫内膜异位	疾病
注射用左卡尼汀	药物
烫伤	疾病
肥儿丸	药物
粪糜蛋白酶	检查科目
薄荷桉油含片	药物
参桂再造丸	药物
代谢性白内障	疾病
醋酸氯己定贴膏	药物
黄色蛋花样稀便	症状
更年期肥胖	症状
溶血	NoneType
云香十五味丸	药物
甘露醇烟酸酯片	药物
焦虑性适应障碍	症状
酒中毒性周围神经病	疾病
跌打伤科酒	NoneType
复方锌糊	药物
隐孢子虫病	疾病
清解冲剂	药物
夏枯草口服液	药物
双氯青霉素钠片	药物
假声现象	症状
清凉润喉片	药物
脾水	疾病
喉上神经损伤	疾病
克罗米通	NoneType
涎腺导管癌	疾病
姜流浸膏	药物
未破裂卵泡黄素化综合征	疾病
脑膜炎疫苗	药物
磷酸氯喹片	药物
继发于严重肝疾患的棘红细胞增多症	疾病
喉淀粉样变	症状
收缩期杂音	症状
伴皮膜粘膜出血	症状
小儿百乐片	药物
骶尾部窦道形成	症状
灯盏花素片	药物
盐酸妥卡尼片	药物
四氮戊省磺酸钠	药物
中度烧伤	症状
裸花紫珠胶囊	药物
八珍益母丸	药物
侧腹壁或后腰部有压痛	症状
菱形-现象	NoneType
二陈丸	药物
刘伍明	NoneType
盐酸哌甲酯	药物
实际碳酸氢盐	检查科目
消渴通脉口服液	药物
注射用膦甲酸钠	药物
巨细胞动脉炎	疾病
炭疽病	疾病
匹多莫德	药物
吲哚美辛三七冰片栓	药物
干性皮肤	NoneType
乳酸司帕沙星片	药物
仙灵脾胶囊	药物
复方羊角颗粒	药物
硇砂膏	药物
枸橼酸莫沙必利分散片	药物
天舒软胶囊	药物
硫酸氨基葡萄糖钾胶囊	药物
乳酸依沙吖啶注射液	药物
复方蒿甲醚片	药物
乙型肝炎核心抗体	检查科目
房室交接区逸搏和逸搏心律	疾病
二甲磺酸阿米三嗪	药物
肠杆菌肺炎	疾病
纳美芬	药物
磺啶新林胶囊	药物
小儿溶血尿毒综合征	疾病
睡眠过度	症状
碳酸钙二甲硅油咀嚼片	药物
赖氨葡锌片	药物
氟曲马唑	药物
丙酯	NoneType
植物血凝素皮内试验	检查科目
乙型肝炎病毒e抗原诊断试剂盒	药物
牙根纵裂	疾病
羊水中有胎粪	症状
替硝唑注射液	药物
碎裂红细胞	检查科目
芩暴红止咳片	药物
恙螨皮炎	疾病
外阴表皮样囊肿	疾病
乳酸环丙沙星滴眼液	药物
葡醛内酯	药物
耳聋左慈丸	药物
口角歪斜，无法说话	NoneType
血色病	疾病
痰咳净	药物
创伤性休克	疾病
龙鹿丸	药物
内斜V征	NoneType
传染病报告卡	NoneType
曲金刚胺	药物
精神病科	医学专科
血清无机磷	NoneType
棕榈氯霉素	NoneType
正骨膏	药物
归脾合剂	药物
金朱止泻片	药物
植物神经系统肿瘤	疾病
性欲减退	疾病
咳痰合剂	药物
着色芽生菌病和暗色丝孢霉病	疾病
开胃消食口服液	药物
磷霉素氨丁三醇散	药物
支气管病	疾病
聚乙二醇1000	NoneType
毛细血管瘤	疾病
大脑萎缩	疾病
米非司酮胶囊	药物
卵泡发育不良	疾病
生脉饮	NoneType
二氯醋酸二异丙胺片	药物
污叉丝孔菌	NoneType
感染性血小板减少性紫癜	疾病
盐酸左旋咪唑肠溶片	药物
中风回春片	药物
色欲伤	疾病
蚂蚁叮咬	疾病
硫酸伪麻黄碱	药物
二糖酶缺乏症	疾病
慢性胃炎	疾病
星状诺卡氏菌	NoneType
痰饮	NoneType
立克次体凝集试验	检查科目
肺泡出血	症状
康媛颗粒	药物
酒精性肝病	疾病
泪腺多形性腺癌	疾病
寰枢关节脱位	疾病
比沙可啶	药物
七叶皂苷钠片	药物
获得性循环抗凝物质增多症	疾病
救惊散	药物
肥大性脊椎炎	疾病
复合维生素B	药物
婴幼儿脐部有肿物突出	NoneType
复方左炔诺孕酮滴丸	药物
b型流感嗜血杆菌结合疫苗	药物
复方风湿药酒	药物
溴西泮	药物
膀胱输尿管反流	NoneType
利鲁唑胶囊	药物
颌下腺肿大	症状
利奈唑烷	NoneType
开郁老蔻丸	药物
大角膜	症状
管状小汗腺癌	疾病
尿外渗	症状
重组人血管内皮抑制素注射液	药物
脊髓内空洞形成	NoneType
牡蛎碳酸钙	NoneType
氢溴酸右美沙芬软胶囊	药物
百特异症状	症状
面红和面红恐惧症	疾病
肾性氨基酸尿	疾病
白塞病性巩膜炎	疾病
盐酸乙哌立松	药物
胃痉挛	NoneType
皲裂疮	疾病
苯磺酸左旋氨氯地平片	药物
高原多血面容	症状
失音	症状
急性髌骨脱位	疾病
复方磷酸可待因糖浆	药物
血小板电泳时间测定	检查科目
抗病毒胶囊	药物
头皮撕脱伤	NoneType
舒肝健胃丸	药物
肩节后脱位	症状
注射用单磷酸阿糖腺苷	药物
盐酸林可霉素软膏	药物
腱索断裂	症状
小儿先天性斜颈	疾病
Backdoor/H	NoneType
脑回状颅皮	疾病
下睑外翻	症状
感冒灵片	药物
获得性免疫缺陷综合征病人的急性阑尾炎	疾病
万通炎康片	药物
胃福颗粒	药物
耻骨直肠肌综合征	疾病
丹毒样外观	症状
苯巴比妥	NoneType
公共卫生事件	NoneType
外搽白灵酊	药物
单纯性下肢静脉曲张	疾病
指甲冻伤	症状
桂龙咳喘宁片	药物
膀胱灵	药物
小儿珍珠镇惊丸	药物
三黄片	药物
股骨头骨折	疾病
车前番泻复合颗粒	药物
氨鲁米特	药物
冻干卡介苗	药物
绝经期尿路感染	疾病
脉压缩小	症状
烟膏	药物
氯咖甘片	药物
盐酸羟钴胺注射液	药物
良性葡萄胎	疾病
女金糖浆	药物
小建中冲剂	药物
卵巢功能异常综合征	疾病
前斜角肌综合征	疾病
顽固性口腔溃疡	症状
齐多夫定片	药物
多器官功能障碍综合征	疾病
化痰消咳片	药物
喹硫平	药物
格列美脲胶囊	药物
杏苏止咳露糖浆	药物
老年久病卧床	疾病
进行性肌营养不良症	疾病
新生儿寒冷损伤综合征	疾病
利多卡因氯己定气雾剂(成膜型)	药物
羊水泡沫试验	检查科目
腹泻与便秘交替	症状
金刚胶囊	药物
安尔眠糖浆	药物
清瘟止痛十一味丸	药物
复方青蒿安乃近片	药物
卡托普利	NoneType
川黄口服液	药物
大株红景天胶囊	药物
血液半乳糖	NoneType
血红蛋白F细胞酸洗脱染色试验	检查科目
眼眶疼痛	症状
益津降糖颗粒	药物
氯唑西林钠	药物
八珍益母膏	药物
腹痛伴便血	症状
甲亢面容	症状
老年人扩张型心肌病	疾病
泌尿感染	疾病
寇热肺炎	疾病
抗溶血性链球菌O试验	检查科目
胃肠道出血	症状
羊水中回声增强增多	症状
直肠重复畸形	NoneType
硫酸特布他林颗粒	药物
奥扎格雷钠葡萄糖注射液	药物
鼻端弥漫性潮红	症状
小肠腺癌	疾病
消旋盐酸甲麻黄碱	药物
河车大造丸	药物
骨增粗	症状
脐周肿胀	症状
脉络膜黑色素瘤	疾病
盐酸甲氯芬酯	药物
定心丸	药物
足踝捩伤	症状
枕颈关节损伤	疾病
肺结核丸	药物
七味酸藤果丸	药物
持续性枕后位、枕横位	疾病
肾上腺皮质功能减退症	疾病
吡布特罗	药物
拉氧头孢	药物
脑性瘫痪	疾病
戈洛帕米	药物
伤寒与副伤寒	疾病
前列闭尔通栓	药物
阿桔片	药物
睡眠-觉醒节律障碍	疾病
癫狂病	疾病
昔萘沙美特罗	NoneType
氧化钙	药物
健脑安神片	药物
精神变态	症状
复方联苯苄唑乳膏	药物
独圣活血片	药物
小儿尿石症	疾病
消旋山莨菪碱片	药物
复方硫黄乳膏	药物
丙型肝炎病毒抗体诊断试剂盒	药物
庚酸炔诺酮	药物
盐酸吗啡缓释片	药物
小肠吸收不良综合征	疾病
尿道结石	NoneType
金砂消食口服液	药物
哌拉西林他唑巴坦	药物
肩胛上神经卡压症	疾病
外伤如意膏	药物
单盐酸氟西泮胶囊	药物
短棒状杆菌制剂	药物
妊娠瘙痒性荨麻疹性丘疹及斑块病	疾病
醋酸地塞米松	NoneType
注射用甲硫酸新斯的明	药物
糖尿病和高血压	疾病
腹部中线处肿块	症状
感冒止咳糖浆	药物
牙本质过敏	疾病
小儿家族性复发性血尿综合征	疾病
淋巴结结核	症状
耳垂缺损	症状
食物过敏性哮喘	疾病
肺内空洞	症状
阿托伐他汀钙胶囊	药物
炔诺孕酮片	药物
小儿用氨基酸注射液(18AA)	药物
庆大霉素	NoneType
尿睾酮	药物
青少年及小儿子宫颈癌	疾病
儿童七珍丸	药物
病理性脱发	症状
腹膜后腔液体渗病	疾病
当归寄生注射液	药物
微血管心绞痛	症状
结膜干燥症	疾病
膝关节肿大	症状
砷中毒	疾病
亮菌甲素片	药物
活血解痛膏	药物
小儿急性气管支气管炎	疾病
临产后俯屈不良	症状
髓核脱水	症状
复方鱼腥草片	药物
神应养真丹	药物
小支气管粘膜水肿	症状
肺气压伤	症状
色素沉着与色素减退	症状
全血硒	NoneType
葡萄糖酸亚铁胶囊	药物
谷维素片	药物
肾骨散	药物
工业中毒所致的精神障碍	疾病
非特异性间质肺炎	疾病
竹红菌素软膏	药物
维胺酯胶丸	药物
新胂凡纳明	药物
结肠黑变	症状
硝酸异山梨酯片	药物
进食异常	症状
劳累后遗精	症状
异美汀	药物
幼虫芽孢杆菌	NoneType
粘液性水肿面容	症状
甲硝唑乳膏	药物
补血宁神片	药物
三氟拉嗪	药物
复方枇杷糖浆	药物
骨痛	症状
枇杷止咳胶囊	药物
小柴胡片	药物
铁染色	NoneType
乳酸与丙酮酸比值	NoneType
回吸性涕血	症状
胸骨骨折	疾病
内脏出血	症状
益龄精	NoneType
止眩安神颗粒	药物
拉米夫定片	药物
指(趾)和小腿出现痉挛及隐痛	症状
川崎病	疾病
灰假杯伞	NoneType
慢性筛窦炎	疾病
眦部缺损或眦缺损	症状
囟门闭合晚	症状
异丁司特缓释片	药物
药品零差价	NoneType
奇孔古尼亚病毒性疾病	疾病
左羟丙哌嗪口服溶液	药物
速效牛黄丸	药物
比托特罗	药物
链球菌坏死	疾病
髓质增生	症状
喘嗽宁胶囊	药物
弗氏柠檬酸杆菌	NoneType
卡尼汀	药物
纯阳正气丸	药物
眨眼不止	症状
感冒水	NoneType
桡神经感觉支卡压	疾病
咽部创伤	疾病
急性脓肿	疾病
双性恋	NoneType
苯扎溴铵溶液	药物
氧雄龙	药物
梅毒肾病	疾病
脊髓海绵状血管瘤	疾病
复脉定颗粒	药物
接骨七厘胶囊	药物
雷贝拉唑钠	药物
疤痕止痒软化乳膏	药物
缩宫素溶液	NoneType
绿脓杆菌	NoneType
双醋炔诺醇	药物
恩屈嗪	药物
内眦赘皮	疾病
前列腺分泌物含有许多脓缩细胞	症状
环扁桃酯片	药物
百宝丹胶囊	药物
化浊轻身颗粒	药物
脉压差低	症状
复方氟尿嘧啶乳	药物
乙肝益气解郁冲剂	药物
消栓通络颗粒	药物
胸椎后纵韧带骨化症	疾病
鲨肝醇	药物
小儿脑积水	疾病
润通丸	药物
色汗	症状
金黄色葡萄球菌脑膜炎	疾病
注射用替加氟	药物
多毛剪股颖柄锈菌	NoneType
原发性肝癌	疾病
膈麻痹	NoneType
愈风宁心片	药物
指甲呈现青紫色	症状
复方金蒲片	药物
醋酸钙片	药物
平滑骨肉瘤	疾病
黄藤素栓	药物
红粉	药物
活络油	药物
养阴口香合剂	药物
盐酸特拉唑嗪片	药物
注射用葡醛酸钠	药物
沙棘油软胶囊	药物
维丙胺胶囊	药物
小儿真菌性肺炎	疾病
乙氧萘西林钠	药物
风湿性边缘性红斑	疾病
司他夫定片	药物
眼睑皮脂腺癌	疾病
眼眶淀粉样变性	疾病
复方阿苯达唑片	药物
感染诱发昏迷	症状
小腿肌肉萎缩	症状
抗巨细胞病毒IgM抗体	检查科目
吞咽干食物时胸骨后有阻塞感或钝痛	症状
头孢雷特	药物
宫颈软	症状
目赤	NoneType
阿立哌唑	药物
宝咳宁糖浆	药物
长春西汀氯化钠注射液	药物
复方银翘氨酚维C片	药物
盐酸环丙沙星栓	药物
创伤性肩关节前脱位	疾病
原发性皮肤结核综合征	疾病
安康颗粒	药物
脓痰	症状
脸部大小不一	症状
半夏糖浆	药物
十香丸	药物
婴儿出牙延迟	症状
格列美脲片	药物
重组人粒细胞巨噬细胞集落刺激因子	药物
皮肤巩膜黄染	症状
海马多鞭丸	药物
小步态	症状
无活动性结核病灶	症状
总甲状腺素	NoneType
糖尿病心肌病	疾病
盐酸妥拉唑林	药物
鼠李铋镁片	药物
盐酸西替利嗪分散片	药物
壮骨木瓜酒	NoneType
突发性右上腹绞痛	症状
麝香痛痹巴布膏	药物
新生儿呼吸窘迫综合征	疾病
清血内消丸	药物
庆大霉素普鲁卡因颗粒	药物
先天性视网膜劈裂症	疾病
止咳喘冲剂	药物
伐地那非	药物
莪术油	NoneType
酞丁安乳膏	药物
语言发育迟缓	NoneType
小儿视网膜色素变性肥胖多指综合征	疾病
眼眶内海绵状血管瘤	疾病
翁沥通颗粒	药物
三磷酸胞苷二钠	药物
五水头孢唑林钠	药物
特布他林	药物
木糖	药物
保婴丹	药物
阴道内胚窦瘤	疾病
童宝乐片	药物
不换金正气散	药物
康妇灵胶囊	药物
维生素B12片	药物
蔓状血管瘤	疾病
罂粟碱	药物
藏毛囊肿	疾病
单组分猪胰岛素	药物
扑尔伪麻片	药物
毛细血管或静脉血栓形成	疾病
小脑畸形	症状
士的宁	药物
腰骶部酸痛	症状
心脉隆注射液	药物
强肝片	药物
尿乳糖	检查科目
女性性早熟	疾病
葡萄球菌类毒素	药物
神经性呕吐	疾病
抗骨增生糖浆	药物
络通酊	药物
肱骨内上髁炎	疾病
复方岩白菜素片	药物
儿童退缩行为	症状
盐酸麻黄碱注射液	药物
百花定喘丸	药物
传导性耳鸣	症状
瞀瘛	疾病
烧伤后肺水肿	疾病
现实解体	症状
益髓颗粒	药物
小儿清解颗粒	药物
情绪性疲劳	症状
先天性无虹膜	疾病
加味逍遥片	药物
颈部怕前屈，怕仰伸	症状
胰岛细胞抗体	检查科目
奥沙西泮片	药物
反复感染	症状
关节囊松弛	症状
持续性腰痛伴有晨僵	症状
眼白蓝灰色或黑色斑点	症状
跌打生骨颗粒	药物
复方羊肝丸	药物
胃溃宁片	药物
苯甲酸钠咖啡因	药物
巩膜炎	疾病
吸附白喉破伤风联合疫苗(成人及青少年用)	药物
胆道感染	NoneType
十八味人参补气膏	药物
三十五味沉香丸	药物
异位急性阑尾炎	疾病
猴耳环消炎颗粒(低糖型)	NoneType
热痹	疾病
杏仁止咳口服液	药物
维生素E胶丸	药物
消旋卡多曲颗粒	药物
上半身代偿性多汗症	疾病
月白珍珠散	药物
清身饮颗粒	药物
贾氏疗法	NoneType
环酯红霉素片	药物
猴耳环消炎颗粒	药物
玉竹冲剂	药物
小儿止泻灵胶囊	药物
阵发性冷性血红蛋白尿	疾病
胆囊的超敏反应	症状
拇指三节	症状
利巴林韦注射液	药物
睡眠中周期性腿动	症状
腹壁硬纤维瘤	疾病
低枸橼酸尿	症状
氧氟沙星注射液	药物
冠心康片	药物
始基囊肿	疾病
气管及支气管发育障碍	疾病
单纯醉酒	NoneType
乳酸性酸中毒	疾病
老年性震颤	NoneType
热带性肺嗜酸粒细胞浸润症	疾病
小儿柴桂退热口服液	药物
加味龟龄集酒	药物
主动脉环扩张	症状
新生儿化脓性脑膜炎	疾病
下背部痛	疾病
手术后膈疝	疾病
小儿疱疹性角膜结膜炎	疾病
葛根素氯化钠注射液	药物
盐酸多塞平注射液	药物
牛黄上清胶囊	药物
利巴韦林颗粒	药物
小儿生理性贫血	症状
透骨灵橡胶膏	药物
盐酸头孢他美酯片	药物
纤维结合蛋白	检查科目
冬白梅片	药物
凝血障碍	症状
滑膜增厚	症状
甘胆酸放射免疫分析药盒	药物
痢疾志贺氏菌	NoneType
毛囊皮脂腺囊性错构瘤	疾病
颞下颌关节脱位	疾病
比生群	药物
小儿马方综合征	疾病
视盘倾斜	症状
注射用胰激肽原酶	药物
三七伤药片	药物
植物神经功能障碍	症状
感冒清热口服液	药物
复方蒲公英注射液	药物
无运动或感觉障碍的运用不能	NoneType
升提颗粒	药物
藿胆丸	药物
肢体远端出现腕垂踝垂	NoneType
阿洛西林	药物
更昔洛韦钠注射液	药物
转移性肝癌	疾病
消旋山莨菪碱	NoneType
纤维单胞菌属	细菌
注射用盐酸硫必利	药物
骨样骨瘤	疾病
甘芍消渴片	药物
蛛网膜下腔出血	症状
单纯疱疹病毒	NoneType
伴高血压	症状
急性结石性胆囊炎	疾病
盐酸左氧氟沙星	药物
苯丙酮尿症筛查试剂盒	药物
血小板ATP释放试验	检查科目
小儿尿道下裂	疾病
支气管发育不全	疾病
异米尼尔	药物
纵膈肿瘤	疾病
五加参颗粒	药物
调胃舒肝丸	药物
盐酸氟西泮胶囊	药物
乙型肝炎表面抗体	检查科目
反射性腰痛	症状
小儿结核性心包炎	疾病
复方紫龙片	药物
渴乐宁颗粒	药物
全天麻胶囊	药物
膜性结膜炎	疾病
盆腔肿块	症状
复方乳酸软膏	药物
磷酸氢钙	NoneType
外阴梅克尔细胞癌	疾病
加利福尼亚脑炎	疾病
肌肉纤维震颤	症状
晕车	症状
肩峰骨折	疾病
急性非特异性睾丸炎	疾病
吲哚洛尔片	药物
氟氯西林钠	药物
人格解体	症状
旋转隐斜	疾病
阻塞性肺气肿	疾病
氟尿嘧啶口服乳剂	药物
脓毒症	疾病
注射用盐酸替罗非班	药物
尿道烧灼感	症状
鼻梁平塌	NoneType
肝加欣片	药物
额部白斑	症状
老年性眩晕	症状
猪苓多糖注射液	药物
复方珍珠暗疮胶囊	药物
糖尿病性肾病	疾病
EB病毒抗体	检查科目
甘珀酸钠胶囊	药物
扁平型骨盆	症状
风寒咳嗽颗粒	药物
颗粒细胞瘤	疾病
保持睡眠障碍性失眠	症状
硼砂甘油钾溶液	NoneType
氧化聚明胶	药物
胃溃疡	疾病
盐酸洛哌丁胺胶囊	药物
小儿双下肢蜷曲	症状
急性脑血管病	疾病
偶氮蓝	药物
肝康宁片	药物
克痤隐酮凝胶	药物
乳头炎和乳晕炎	疾病
铁蛋白放免药盒	药物
乙型肝炎病毒e抗原酶联试剂盒	药物
阿拉坦五味丸	药物
注射用顺铂	药物
曲帕胺	药物
翼状胬肉	疾病
手部肌腱损伤	疾病
灵杆菌	NoneType
朱砂莲胶囊	药物
Shy-Drager综合征	疾病
妊娠时持续性腹痛或腰酸腰痛	症状
剥脱性皮炎型药疹	疾病
归脾丸浓缩丸	药物
过度通气综合征	疾病
特洛伊病毒Win32.Cutwail.GG	NoneType
吗啉胍	药物
三味蒺藜散	药物
肢端缺血	症状
膀胱刺激征	症状
中风	疾病
弗郎西丝菌肺炎	疾病
真菌中毒症	疾病
角弓反张	症状
小儿眼-耳-脊椎综合征	疾病
百癣夏塔热胶囊	药物
诺氟沙星滴眼液	药物
尼麦角林片	药物
类鼻疽	疾病
一时性便秘	症状
匐行性脉络膜炎	疾病
止嗽青果丸	药物
硝酸甘油溶液	药物
肠系膜上静脉血栓形成	疾病
异丙嗪胆汁片	药物
尿液雌酮	药物
气瘿	疾病
脊索瘤	疾病
口腔尖锐湿疣	疾病
婴儿吐奶	症状
易于产生病理嫉妒信念	症状
注射用头孢噻吩钠	药物
冷凝集素综合征	疾病
盐酸布替萘芬乳膏	药物
越鞠丸	药物
玫瑰糠疹	疾病
埃可病毒抗体	检查科目
大活络丹	药物
经期浮肿	症状
突眼症	症状
癫痫的复杂部分性发作	症状
成人腹股沟斜疝	疾病
甘草酸二铵肠溶胶囊	药物
夏枯草胶囊	药物
克里米亚-刚果出血热	NoneType
匐行性脉络膜萎缩	疾病
泛影酸	NoneType
沙溪凉茶	药物
氨基己酸注射液	药物
血管母细胞瘤	疾病
成瘾	症状
七叶皂苷钠	药物
小儿咳喘灵颗粒	药物
蝎螫伤	疾病
粉红色泡沫样痰	症状
正胃片	药物
硫酸奈替米星	NoneType
牙病	疾病
干酵母片	药物
当归芍药颗粒	药物
平安丸	药物
超量饮酒后两下肢突然出现痉挛和疼痛	症状
健儿散	药物
小颌	症状
二溴甘露醇	药物
选择性培养基	NoneType
双歧三联活菌	药物
柏子养心丸	药物
泻定胶囊	药物
保胎无忧散	药物
降脂平口服液	药物
盐酸美司坦片	药物
奋乃静	NoneType
聚磺苯乙烯钠	药物
无症状性菌尿	症状
润肌皮肤膏	药物
小汗腺汗囊肿	疾病
面裂	疾病
排毒清脂胶囊	药物
油漆皮炎	疾病
鼠疫菌诊断血清	药物
丘疹性荨麻疹	疾病
气管阻塞	症状
萘普生片	药物
快速血浆反应素环状卡片试验	检查科目
氟卡尼	药物
小儿肥胖症	疾病
急性糜烂性胃炎	疾病
妇科十味片	药物
眼面痛	症状
睾丸触痛	症状
八味肉桂胶囊	药物
吸附精制百白破混合制剂	药物
产气肠杆菌	症状
润肠丸(浓缩丸)	NoneType
乳腺导管瘤	疾病
乙型溶血性链球菌	病毒
注射用更昔洛韦	药物
黄瓜花叶病毒	病毒
司帕沙星片	药物
鱼鳞病	疾病
溶组织内阿米巴病	疾病
卵巢两性母细胞瘤	疾病
环吡酮胺乳膏	药物
野靛碱	药物
保婴散	药物
溃疡分泌物恶臭	症状
磷酸哌嗪片	药物
富马酸亚铁颗粒	药物
平湖褐蛉	NoneType
糖类皮质激素分泌过多	症状
牙内吸收	疾病
老年肺炎	疾病
百贝益肺胶囊	药物
苦参阴道泡腾片	药物
小脑脑桥角脑膜瘤	疾病
胆酸	药物
左、右腰腹痛	症状
一侧胸廓塌陷	症状
福尔马林中毒	疾病
颈部皱纹多	症状
无锡伤药	药物
丹葶肺心颗粒	药物
甲磺酸氨氯地平片	药物
黄枣颗粒	药物
类风湿关节炎	疾病
多囊卵巢综合征	疾病
健康线异常	症状
良园枇杷叶膏	药物
心胃止痛胶囊	药物
消白软膏	药物
磷酸川芎嗪氯化钠注射液	药物
头孢丙烯咀嚼片	药物
乙型肝炎病毒核心抗体诊断试剂盒	药物
高脂蛋白血症Ⅱ型	NoneType
氟脲嘧啶	NoneType
老年人骨髓增生异常综合征	疾病
葡甘聚糖胶囊	药物
泛酸钙	NoneType
粪量	检查科目
噻康唑	药物
硫普罗宁	药物
晶状体混浊	症状
食管重复畸形	疾病
清火栀麦片	药物
小儿脉络丛乳头状瘤	疾病
三七脂肝颗粒	药物
托氟沙星	药物
血清球蛋白	药物
嗜酸细胞增多性复发性肉芽肿皮炎	疾病
巩膜外层炎	疾病
重组人干扰素	药物
四环素醋酸可的松眼膏	药物
高度膨胀的毛细血管襻	症状
三乌胶丸	药物
复方松醇那敏片	药物
硫酸西索米星注射液	药物
咽部异物	疾病
抗麸质抗体	检查科目
去氢胆酸	药物
马来酸麦角新碱注射液	药物
强力枇杷露(炼蜜)	药物
异山梨醇	药物
龙血竭片	药物
布康唑	药物
下肢短缩	症状
乌鸡白凤胶囊	药物
尿液去甲肾上腺素	NoneType
月经时多时少且淋漓不断	NoneType
龟甲养阴片	药物
盐酸洛美沙星片	药物
安纳咖	NoneType
大骨节病	疾病
慢性纵隔炎	疾病
苄星青霉素	NoneType
尿沉渣细胞学	检查科目
急性肺源性心脏病	疾病
根尖脓肿	疾病
老年人溶血性贫血	疾病
多腺体缺陷综合征	疾病
声带老化	症状
胃寒疼痛	症状
华法林	NoneType
双氯灭痛	药物
醋酸苯汞	药物
复方鱼腥草软胶囊	药物
缺血性结肠炎	疾病
大山楂丸	药物
镇咳宁糖浆	药物
右归丸	药物
无汗腺导管角质护膜分化	症状
脊柱畸形	疾病
小儿皱梅腹综合征	疾病
诺氟沙星药膜	药物
更年期综合征	疾病
膝关节软弱无力	症状
铝骨病	疾病
健胃十味丸	药物
肾盏变钝	症状
川芎茶调袋泡剂	药物
妇宝冲剂	药物
红酵母属	NoneType
导赤丸	药物
血浆蛋白检测试剂补体成份C4抗血清	NoneType
正中菱形舌炎	疾病
醋酸氯已定痔疮栓	NoneType
香青百草油搽剂	药物
消渴康颗粒	药物
阿氯米松	药物
局限型间皮瘤	疾病
小儿声带损伤	症状
膀胱瘘	疾病
感染性流产	症状
金参润喉合剂	药物
呼吸减慢而不规则	症状
舒秘胶囊	药物
鼻咽肉瘤	疾病
十一酸睾酮胶囊	药物
指、趾甲显现苍白痕或脱落	NoneType
卵巢纤维瘤	疾病
鹿茸洋参片	药物
盐酸特比萘芬阴道泡腾片	药物
那法瑞林	药物
复方氨维胶囊	药物
盐酸尼卡地平注射液	药物
口服酪酸梭菌双歧杆菌二联活菌胶囊	药物
腹腔肺吸虫病	疾病
富马酸酮替芬口服溶液	药物
手部神经损伤	疾病
硫酸头孢噻利	药物
颌骨骨折	疾病
续断壮骨胶囊	药物
丁公藤风湿药酒	药物
脑苷肌肽注射液	药物
脱氧核苷酸钠片	药物
缺血性视神经病变	疾病
木香顺气颗粒	药物
甲硫氧嘧啶片	药物
清热解毒注射液	药物
脂肪泻	NoneType
筋膜疼痛	症状
二十一味寒水石散	药物
心悸	症状
清热解毒颗粒	药物
盐酸伐昔洛韦胶囊	药物
抗菌消炎片	药物
大肠杆菌噬菌体	病毒
盐酸芬氟拉明片	药物
帕珠沙星	药物
嗜酸性筋膜炎	疾病
喉狭窄	NoneType
盐酸小檗碱	药物
脾气虚	症状
曲尼司特胶囊	药物
维生素K缺乏	NoneType
复方苯甲酸酊	药物
锁骨下动脉-腋动脉瘤	疾病
颧骨骨折	疾病
中西医结合科	医学专科
止痛水	药物
马来酸咪达唑仑	药物
华佗风痛宝片	药物
肾上腺皮质功能减退性心脏病	疾病
脉率增快	症状
耻区肿块	症状
葡萄糖酸钙注射液	药物
颅内生殖细胞瘤	疾病
硫酸小诺霉素口服液	药物
健肾益肺口服液	药物
促黄体生成激素放免药盒	药物
注射用降纤酶	药物
二甲双胍	药物
乳房缺少症	疾病
三角头畸形	症状
羊藿三七片	药物
巩膜葡萄肿	疾病
制霉菌素阴道泡腾片	药物
多发性骨髓瘤病肾病	疾病
克痹骨泰片	药物
颠倒散	药物
盐酸伐昔洛韦	药物
低分子右旋糖酐氨基酸注射液	药物
亚临床甲状腺功能减退症	疾病
皮肤黑斑	症状
酒红链霉菌	细菌
小儿阵发性心动过速	疾病
磺胺二甲嘧啶	NoneType
十全大补丸浓缩丸	药物
盐酸酚苄明注射液	药物
淋巴瘤样肉芽肿	疾病
关节克痹丸	药物
肢体障碍	症状
穿心莲内脂片	药物
羧甲淀粉钠溶液	药物
复视	症状
三磷酸腺苷二钠片	药物
滋养细胞肿瘤	疾病
葡萄糖磷酸异构酶缺乏症	疾病
胃窦狭窄	症状
摩擦黑变病	疾病
盐酸洛美沙星软膏	药物
鸦胆子油口服乳液	药物
弹响肩胛	疾病
小肠实热	疾病
皮肤胎痣	症状
清心明目上清丸	药物
六味地黄胶囊	药物
壮热	疾病
髓性多汗症	疾病
眼眶真菌病	疾病
肛肠疾病	疾病
番泻叶	NoneType
地丁三味汤散	药物
吸气时胸口痛	症状
牙齿发黄	症状
牙痛	NoneType
顺铂	NoneType
胎儿酒精影响	症状
双氢可待因	药物
性功能障碍	疾病
盐酸贝那普利	药物
脐部有一半球形肿块	症状
天麻素	药物
骨端增大	症状
两手颤抖	症状
硝酸益康唑乳膏	药物
硝苯地平	药物
金嗓利咽胶囊	药物
复方木鸡颗粒	药物
高峰胃酸分泌量	NoneType
双氢青蒿素哌喹片	药物
耳闷	症状
脑软化	症状
积液腺苷脱氢酶	检查科目
肾上腺转移	症状
睾丸淋巴瘤	疾病
安神镇惊二十味丸	药物
盐酸丙哌维林片	药物
发酵乳杆菌	NoneType
曲克芦丁颗粒	药物
血清甲胎蛋白升高	症状
阿魏酸哌嗪	药物
乙酰麦迪霉素片	药物
血浆蛋白检测试剂触珠蛋白(HP)抗血清	NoneType
甘参胶囊	药物
正清风痛宁注射液	药物
抗感胶囊	药物
席汉氏综合症	疾病
右心衰竭	症状
弯曲菌性肠炎	疾病
酚软膏	药物
肾髓质囊性病	疾病
盐酸可乐定滴眼液	药物
盐酸溴己新注射液	药物
复方氨基酸颗粒(9AA)	药物
细辛脑胶囊	药物
痱子粉	NoneType
肘关节强直	疾病
小儿先天性肾病综合征	疾病
脂降宁片	药物
复方氨酚苯海拉明片	药物
克痤隐酮乳膏	药物
宁神丸	药物
小儿亚硝酸盐中毒	疾病
养血口服液	药物
乳腺肿瘤	疾病
感冒丸	药物
二巯丁二酸	药物
复方铝酸铋	药物
血浆黏度	检查科目
风湿痛药酒	药物
老年人肠易激综合征	疾病
狗皮膏(改进型)	药物
止嗽立效丸	药物
游离三碘甲腺原氨酸放射免疫分析药盒	药物
珍珠八宝眼药	药物
甲磺酸加替沙星氯化钠注射液	药物
盐酸氯丙嗪片	药物
勒马回注射液	药物
芪参通络胶囊	药物
蒙脱石散剂	药物
偏执型人格障碍	疾病
玉兰降糖胶囊	药物
溃疡分枝杆菌感染	疾病
牙齿颜色异常	症状
杏灵片	药物
注射用重组人粒细胞集落刺激因子	药物
老年人缺铁性贫血	疾病
牙周牙髓联合病变	疾病
小儿甲状旁腺功能减退症	疾病
养血饮口服液	药物
球形红细胞	NoneType
复方硫酸新霉素滴眼液	药物
一枝蒿伤湿祛痛膏	药物
外伤性食管穿孔	疾病
手掌深部间隙感染	疾病
洛索洛芬钠颗粒	药物
氮芥	药物
气管及食管异物	疾病
浅层点状角膜炎	疾病
膀胱尿道异物	疾病
颈后及肩部皮肤发硬	症状
腐败希瓦氏菌	NoneType
四肢瘫痪	症状
肝必复软胶囊	药物
尿激酶	NoneType
益智康脑丸	药物
手掌硬性水肿	症状
利贝特	药物
尪痹颗粒	药物
盐酸米托蒽醌	药物
桥脑梗塞	症状
咽旁脓肿	疾病
新生儿震颤	症状
前列回春片	药物
咽部异物感	症状
棘阿米巴性巩膜炎	疾病
钩端螺旋体乳胶凝集试验	检查科目
脑干胶质瘤	疾病
拇指征	症状
苯丙酸诺龙	药物
脑痉挛	NoneType
阳和解凝膏	药物
亚硝酸钠注射液	药物
参芪首乌补汁	药物
高血脂	症状
汞毒性震颤	症状
注射用甲硝唑	药物
丘疹性血管增生	疾病
眼眶横纹肌肉瘤	疾病
老年人前列腺癌	疾病
地奈德	药物
双氯芬酸钠注射液	药物
医源性胆管损伤	疾病
异染性脑白质营养不良	疾病
刘允怡	NoneType
醒脑库克亚片	药物
反射性晕厥	NoneType
小儿脊髓损伤	疾病
水杨酸二乙胺	药物
心气虚	疾病
夜惊	疾病
氨苄西林钠	药物
鼻甲肿胀	症状
眼底出血	NoneType
吞气症	疾病
伏格列波糖分散片	药物
恶性脑膜瘤	疾病
头孢地尼胶囊	药物
小儿阻塞性睡眠呼吸暂停	疾病
复方春砂颗粒	药物
钙尔奇D600片	药物
心悸伴心率异常	症状
银杏叶酊	药物
宫颈腺癌	疾病
奥硝唑	药物
肠郁	疾病
甘草次酸	药物
食管瘢痕性狭窄	疾病
磷酸川芎嗪胶囊	药物
脓疱病	疾病
斯蒂尔病	疾病
腺性唇炎	疾病
肝素	药物
咽部脊索瘤	疾病
筋骨宁搽剂	药物
四环素碱	NoneType
碳酸钙泡腾颗粒	药物
阴道血吸虫病	疾病
罗红霉素细粒剂	药物
三磷酸胞苷二钠注射液	药物
神曲胃痛片	药物
急性单纯疱疹病毒性脑炎	疾病
黄连双清丸	药物
肝胃不和	疾病
梅苏冲剂	药物
辐射性白内障	疾病
秃头	症状
牛黄蛇胆川贝散	药物
滑膜炎胶囊	药物
吗啡	药物
硝酸甘油葡萄糖注射液	药物
湿热蕴脾	疾病
劳累时腰部酸痛或胀痛	症状
输卵管炎	疾病
麝香拔湿膏	药物
氢吗啡酮	药物
外眼源性眩晕	症状
胱氨酸储积症	症状
广羚散	药物
膀胱憩室	疾病
冠状动脉窃血现象	症状
风热感冒颗粒	药物
舒马普坦	药物
颈肋畸形	疾病
膀胱癌	疾病
铝镁加混悬液	药物
乳果糖	NoneType
复方盐酸利多卡因注射液	药物
寒冷刺激下皮损表面出现皱缩	症状
舒冠通糖浆	药物
骨刺片	药物
哈西奈德软膏	药物
注射用硫酸西索米星	药物
华法林钠片	药物
妇女痛经颗粒	药物
鼻塞通滴鼻剂	药物
蛇伤散	药物
双氯芬酸钠米索前列醇	药物
芽生菌补体结合试验	检查科目
硫酸阿奇霉素	药物
氧氟沙星眼膏	药物
止喘灵气雾剂	药物
扑米酮片	药物
双黄连含片	药物
胸降主动脉严重狭窄	NoneType
外阴呈幼稚型无阴毛	症状
臂痛	症状
银翘散袋泡剂	药物
益坤丸	药物
灾难反应	症状
盐酸丁咯地尔注射液	药物
丛石鸻	NoneType
入睡困难	症状
卡泊芬净	药物
小儿清肺止咳片	药物
鼻唇沟发红皲裂	症状
戒断反应	症状
已烯雌酚片	药物
注射用盐酸多沙普仑	药物
酒石酸双氢可待因片	药物
苦金片	药物
双眼向上凝视	症状
益母丸	药物
左羟丙哌嗪胶囊	药物
鼻甲萎缩	症状
速效止泻胶囊	药物
胃痛定	药物
妇科白凤口服液	药物
流痰	疾病
海墨止血片	药物
双唑泰栓	药物
老年人腔隙性脑梗死	疾病
三七胶囊	药物
喉咙痒	症状
科干综合征	疾病
月见草油	药物
荆花胃康胶丸	药物
舒眠	药物
小管间质性肾炎	疾病
升华硫	药物
邻苯二醛	药物
氟尼缩松	药物
湿热痹胶囊	药物
左炔诺孕酮片	药物
毛囊脓疱病	疾病
儿脾醒颗粒	药物
熊胆开明片	药物
地奥司明片	药物
重复肾盂输尿管畸形	疾病
利凡诺软膏	药物
痛经宁糖浆	药物
西尼罗河热	疾病
婴儿手足搐搦症	疾病
枸橼酸钾口服溶液	药物
导肠粒	药物
甲状腺功能减退	疾病
分娩	NoneType
血清碱性磷酸酶	检查科目
亚叶酸钙	药物
小儿消化道出血	疾病
急性心力衰竭	疾病
奥扎格雷钠	药物
科氏芽孢杆菌	NoneType
黑癣	疾病
皮肤出血斑	症状
口腔颌面部损伤	疾病
维生素B12注射液	药物
齐美定	药物
肛门会阴区潮湿不洁	症状
齿轮样强直	症状
醋酸氟氢可的松	药物
利培酮胶囊	药物
清胃和中丸	药物
血浆蛋白检测试剂兔抗人血清	药物
风热感冒	疾病
复方皂矾胶囊	药物
心悦胶囊	药物
假菊形团结构	症状
维生素K1	药物
黑点银纹夜蛾核多角体病毒	NoneType
盆炎净口服液	药物
听觉疲劳	症状
苦豆子片	药物
体外培育牛黄	NoneType
余良卿膏药	药物
血浆蛋白检测试剂高密度脂蛋白(HDL)抗血清	NoneType
五海瘿瘤丸	药物
骨髓-胰腺综合征	疾病
千紫红片	药物
多形性日光疹	疾病
复方矮地茶胶囊	药物
金振口服液	药物
下巴关节疼	症状
外阴乳头状瘤	疾病
结肠炎	疾病
当归片	药物
多疑	症状
金莲花润喉片	药物
宫颈癌	疾病
脑安颗粒	药物
八正胶囊	药物
参芪消渴颗粒	药物
抗感颗粒	药物
脑室炎	疾病
精液酸度	检查科目
抗菌消炎胶囊	药物
幽门管溃疡	症状
血清甲状腺素	检查科目
复方克罗米通乳膏	药物
盐酸非那吡啶	药物
双酚伪麻糖浆	药物
氟氯西林钠阿莫西林胶囊	药物
乌梅人丹	NoneType
手掌和足底角化伴多汗	症状
六味地黄丸(浓缩丸)	NoneType
盐酸雷尼替丁泡腾片	药物
小儿脓窠疮	疾病
小儿骨硬化病	疾病
原卟啉钠	药物
二十六味通经散	药物
思维奔逸	症状
注射用门冬氨酸洛美沙星	药物
木瓜片	药物
硫鸟嘌呤片	药物
老年人低钠血症	疾病
肘外侧夜间痛	症状
常通舒冲剂	药物
阿司匹林双嘧达莫缓释片	药物
皮下脂肪萎缩	NoneType
甲硝唑胶浆含漱液	NoneType
心痛宁喷雾剂	药物
开塞露(含甘油)	药物
散风活血膏	药物
盐酸拓扑替康	药物
水杨酸镁片	药物
苦参素片	药物
咖酚伪麻片	药物
养血安神片	药物
上呼吸道卡他症状	NoneType
寻常性鱼鳞病	疾病
癃闭通胶囊	药物
复方消化酶	药物
注射用灵杆菌多糖	药物
短膜壳绦虫病	疾病
面下部头痛	症状
奥美沙坦酯片	药物
复方甘草麻黄碱片	药物
降糖胶囊	药物
老年人食管癌	疾病
腰痛片	药物
皮肤出现硬块	症状
参芪鹿茸口服液	药物
司他夫定	药物
腰疼丸	药物
变性性近视的眼底损害	疾病
牙关紧闭	症状
双耳廓缺损	症状
尿半乳糖	NoneType
连柏烧伤膏	药物
腰痛	NoneType
胃疡灵颗粒	药物
注射用利福霉素钠	药物
金樱首乌汁	药物
致密性骨发育障碍	疾病
双扑伪麻片	药物
维生素B2	药物
巴瑞特综合征	疾病
阴囊肿大	症状
胰腺功能不足	症状
暗色丝孢霉病	疾病
豨莶通栓胶囊	药物
虹膜囊肿	疾病
鼻恶性肉芽肿及淋巴瘤	疾病
性施虐癖	症状
西兰司琼	药物
老年女性膀胱颈梗阻	疾病
慢性肾性贫血	疾病
颅骨结核	疾病
卡托普利片	药物
种子三达丸	药物
回春如意胶囊	药物
黏多糖贮积症Ⅷ型	NoneType
木霉	细菌
三维鱼肝油乳	药物
腮腺混合瘤	疾病
硝苯地平片	药物
逍遥口服液	药物
地诺前列素	药物
原发性心脏淋巴瘤	疾病
皮肤利什曼病	疾病
痔炎消颗粒	药物
L精氨酸	NoneType
正柴胡饮冲剂	药物
冠脉宁胶囊	药物
小儿腹泻病	疾病
通脉降糖胶囊	药物
宝灵肝胆护理丸	药物
炔雌醚	NoneType
不断眨眼	症状
咽炎、舌炎、龈炎	疾病
泛菌	NoneType
吸收性明胶海绵	NoneType
牡蛎碳酸钙咀嚼片	药物
瘀斑性环	症状
阑尾感染	NoneType
细网状到斑片状的色素沉着	症状
皮肤松垂	疾病
拨云退翳丸	药物
呃逆症	疾病
心肌梗死后心包炎	疾病
落枕	NoneType
色甘酸钠	药物
肛乳头炎	疾病
寻常疣	疾病
女性不孕	症状
葡萄糖酸亚铁糖浆	药物
复方硫磺乳膏	药物
非结核分枝杆菌性角膜炎	疾病
乙型肝炎病毒性关节炎	疾病
输卵管积水	疾病
马杜拉放线菌	细菌
尾骶部疼痛	症状
祁门蛇药片	药物
原发性单克隆免疫球蛋白病	药物
白灵片	药物
心肌细胞的浊肿	NoneType
过敏性结膜炎	疾病
羊痘	疾病
肠穿孔	NoneType
寒湿泄泻	疾病
甘草酸单钾盐	NoneType
头孢氨苄片	药物
盐酸莫雷西嗪片	药物
依地酸二钠	药物
胎动过频	症状
金葡液	药物
甲内型甲真菌病	疾病
抗胰蛋白酶缺乏症	疾病
下颌下间隙感染	疾病
胃食管反流病	疾病
替莫唑胺	药物
二十五味松石丸	药物
小儿病毒感染性口炎	疾病
御制平安丸	药物
伤湿丸	药物
麻疹疫苗	药物
踝关节骨折	疾病
皮肤瘙痒症	疾病
宝儿康散	药物
桃花散	药物
外阴疣状癌	疾病
脂肪肉瘤	疾病
儿感清口服液	药物
痒点	疾病
周围性软骨肉瘤	疾病
顺苯磺酸阿曲库铵	药物
三蛇风湿药酒	NoneType
输尿管肿瘤	疾病
顽固性失眠	症状
颊间隙感染	疾病
得生胶囊	药物
蛇胆川贝含片	药物
旋毛虫病	疾病
荨麻疹丸	药物
苯唑青霉素钠胶囊	药物
小儿酚黄那敏颗粒	药物
杆菌肽	药物
哈敦海鲁木勒九味丸	药物
盐酸莫索尼定片	药物
注射用盐酸索他洛尔	药物
婴儿过胖	症状
管性呼吸音	症状
眼睑下垂	症状
淀粉酶口服溶液	NoneType
急性泪囊炎	疾病
美洛西林钠	药物
一过性意识蒙眬	症状
胃空肠输入袢综合征	疾病
注射用法莫替丁	药物
网眼样痴呆	症状
补脑安神胶囊	药物
消络痛片	药物
曲米帕明	药物
头大畸形	症状
气滞血瘀	症状
梅毒性葡萄膜炎	疾病
苯磺酸氨氯地平片	药物
心脑联通胶囊	药物
清喉咽合剂	药物
鞘氨醇单胞菌	NoneType
宁嗽露糖浆	药物
外阴黑色棘皮症	疾病
舒心宁口服液	药物
黄芩胶囊	药物
如意金黄散	药物
乳酸加替沙星氯化钠注射液	药物
溃疡龛影	症状
带血性分泌物	症状
恶性肿瘤	疾病
下腹剧痛并渐向腹中线扩散	药物
二十二烷醇	药物
口洁喷雾剂	药物
乌拉地尔	药物
灯盏生脉胶囊	药物
腹腔种植	症状
恶性胸腔积液	疾病
小儿七星茶糖浆	药物
颈椎痛	症状
乳腺康注射液	药物
磷酸萘酚喹片	药物
复方仙茅补肾口服液	药物
牙齿呈黄色浅灰色或深灰色	NoneType
黏液性水肿	症状
扎来普隆片	药物
等孢球虫病	疾病
空心胶囊	药物
小儿细菌感染性口炎	疾病
小儿硬皮病	疾病
中指指甲凹陷	症状
晶状体溶解性青光眼	疾病
姜竭补血合剂	药物
功能性呕吐	疾病
腓骨近端骨折	疾病
皮肤丝虫病	疾病
羚羊感冒口服液	药物
曲棍球棒手	症状
益心丸	药物
甲型肝炎IgM抗体酶标诊断试剂盒	药物
风温	NoneType
尿道旁腺癌	疾病
椎动脉迂曲痉挛	症状
加味香连丸	药物
肝脂肪变	症状
右旋糖酐铁片	药物
替普瑞酮	药物
镰状细胞病	疾病
青叶胆提取物	药物
宫腔积血	症状
佐匹克隆	药物
位置性眩晕	疾病
下消化道出血	疾病
全腹痛	症状
骨间肌和鱼际肌萎缩	症状
萝巴新	药物
五肽胃泌素注射液	药物
伸筋活络丸	药物
根分叉病变	NoneType
单发脑梗死性痴呆	疾病
水杨酸钠碘化钠注射液	药物
人源化美卡舍明	药物
外伤科	医学专科
卡介菌多糖核酸制剂	药物
复方一枝蒿颗粒	药物
胃嵌顿	症状
肺吸虫病	疾病
克洛己新片	药物
解毒利咽丸	药物
血清鸟氨酸氨基甲酰转移酶	检查科目
当归拈痛颗粒	药物
脉安冲剂	药物
盐酸丁氯喘片	药物
免疫性肾炎	疾病
膀胱炎	疾病
耳硬化症	疾病
复方银翘氨敏胶囊	药物
通塞脉颗粒	药物
射干利咽口服液	药物
药物性肥胖	症状
复方藤果痔疮栓	药物
泛发性特发性毛细血管扩张	疾病
溴中毒	疾病
品他病	疾病
烟雾病	疾病
壬苯醇醚栓	药物
骶椎腰化	症状
柘木颗粒	药物
大肠黑变	症状
神经源性角膜炎	疾病
浓煤焦油溶液	NoneType
胃泌素瘤	疾病
凹陷瘢痕	症状
安多霖胶囊	药物
泌淋颗粒	药物
精液发黄	症状
骨恶性淋巴瘤	疾病
小儿香桔丹	药物
肝硬化腹水	疾病
肝浸膏片	药物
如意定喘片	药物
隐斜视	疾病
氨苄西林胶囊	药物
红花黄色素氯化钠注射液	药物
消渴安胶囊	药物
麻黄碱苯海拉明片	药物
甲砜霉素胶囊	药物
虹膜缺损	症状
胃部隐痛	症状
复方丹参注射液	药物
岩藻糖苷贮积症	疾病
五粒回春丸	药物
氧化锌升华硫软膏	药物
阿度西林	药物
降脂胶丸	药物
胰多肽	NoneType
卵巢颗粒细胞瘤	疾病
胃肠动力差	症状
胃得乐	药物
比阿培南	药物
畏热	症状
复方氨酚愈敏口服溶液	药物
伤食泄泻	疾病
冻僵	疾病
滋阴补肾丸	药物
杆菌肽眼膏	药物
注射用复合辅酶	药物
阴茎疼痛	症状
肝肾综合征	疾病
金莲胃舒片	药物
复方莲芯口服液	药物
益心胶囊	药物
输卵管卵巢脓肿	疾病
普通花叶病	疾病
高原肺水肿	疾病
依前列醇	药物
谷氨酸钾注射液	药物
颈背疼痛	症状
夏天无眼药水	NoneType
急性鼻炎	疾病
尺桡骨干骨折	疾病
小牛血去蛋白提取物氯化钠注射液	药物
复方氨苯蝶啶胶囊	药物
砂仁驱风油	NoneType
三磷酸腺苷二钠氯化镁注射液	药物
七味肝胆清胶囊	药物
水中毒性昏迷	症状
油彩皮炎	疾病
更昔洛韦葡萄糖注射液	药物
Felty综合征	疾病
葡醛酸钠注射液	药物
小儿复方四维亚铁散	药物
苍夷滴鼻油	NoneType
埃德温·福斯特·柯丁	药物
胆宁片	药物
一把抓	药物
掌跖发红	症状
莪树油	NoneType
单纯性肺嗜酸粒细胞浸润症	疾病
乳腺组织肥厚	症状
愈伤膏	药物
褐色高温单孢菌	NoneType
环戊噻嗪	药物
香砂养胃丸	药物
双梅喉片	药物
尿前列腺素	NoneType
秋水仙碱片	药物
膀胱纤维化	症状
耳外伤	疾病
健肾壮腰丸	药物
泪腺分泌功能减退	疾病
小诺米星	药物
富马酸亚铁	NoneType
苍苓止泻口服液	药物
下尺桡关节脱位	疾病
感冒咳嗽片	药物
着色性干皮病	疾病
盐酸司他斯汀	药物
禽流感病毒	病毒
沙苑子颗粒	药物
新生儿Wilson-Mikity综合征	疾病
恶性营养不良病	疾病
胃十二指肠溃疡瘢痕性幽门梗阻	疾病
博安霉素	药物
盲襻综合征	疾病
牙髓病	疾病
甲状腺功能亢进性肝病	疾病
疼痛弧征	症状
冰硼散	药物
生理性萎缩	症状
丁型病毒性肝炎	疾病
足背及胫后动脉搏动减弱	症状
盲点	症状
附睾炎	疾病
唐氏综合征	疾病
腹水	NoneType
产灵丸	药物
醒脾开胃冲剂	药物
红细胞计数	检查科目
血液透析液	药物
罗沙替丁	药物
威骨颗粒	药物
酚美愈伪麻口服液	药物
黄氏响声茶	药物
复张性肺水肿	疾病
强肝口服液	药物
避瘟散	药物
癃闭舒胶囊	药物
增生性毛根鞘瘤	疾病
清泻丸	药物
马拉硫磷	药物
肌腱炎和腱鞘炎	疾病
脑静脉畸形	疾病
头孢特仑新戊酯	药物
氯喹那多	NoneType
肌肉紧张性疼痛	症状
孤立肾	疾病
尿道与阴茎结核	疾病
小儿脱屑性肺炎	疾病
乳头状汗腺腺瘤	疾病
成人斯蒂尔病	疾病
妇女痛经丸	药物
温肾全鹿丸	药物
链霉菌属	细菌
复方刺五加片	药物
舒筋定痛片	药物
呕吐	NoneType
正清风痛宁缓释片	药物
长Q-T间期综合征	疾病
急性单纯外伤性腰腿痛	疾病
胞二磷胆碱注射液	药物
八味锡类散	药物
结肠袋半月襞消失	症状
尺骨上1/3骨折合并桡骨头脱位	NoneType
腹壁静脉怒张	症状
四肢麻木	症状
摸空症	疾病
卡立普多	药物
羊水过多	疾病
乌鸡白风丸	药物
尿毒症	疾病
颞叶肿瘤	疾病
三花接骨散	药物
妊娠期血糖高	症状
心脑舒通片	药物
双香豆乙酯	药物
瘤体牵拉	症状
保和丸	药物
复方克霉唑乳膏	药物
耆鹿逐痹口服液	药物
水疝	疾病
抗着丝点抗体	检查科目
哌嗪	药物
小儿复方磺胺二甲嘧啶散	药物
托西酸舒他西林分散片	药物
盐酸萘甲唑林滴鼻液	药物
脐带脱垂	疾病
阿片烟	NoneType
进行性骨干发育不良	疾病
腹壁反射减弱或消失	症状
小儿柞蚕蛹性脑病综合征	疾病
心排血量减少	症状
低血糖惊厥	症状
心通颗粒	药物
寒水石二十一味散	药物
杏香兔耳风胶囊	药物
重组人表皮生长因子滴眼液	药物
尼索地平片	药物
铝镁混悬液	药物
五酯胶囊	药物
胫骨后唇骨折	疾病
龙牡壮骨咀嚼片	药物
慢性进行性舞蹈病	疾病
扁桃体小或缺如	症状
头晕	症状
指端出现Osler结节	NoneType
嗜碱性点彩红细胞	检查科目
富马酸氯马斯汀干混悬剂	药物
吡硫醇	药物
结核性膀胱自发破裂	疾病
千金止咳丸	药物
低血压	NoneType
散寒药茶	药物
止泻保童颗粒	药物
右丙亚胺	药物
链道酶	药物
得生丸	药物
硫酸沙丁胺醇雾化吸入溶液	药物
布洛芬糖浆	药物
左炔诺孕酮炔雌醚片	药物
奋森咽峡炎	疾病
金嗓散结片	药物
开胃丸	药物
三相避孕片	药物
吗啡阿托品注射液	药物
七珠健胃茶	药物
皮肤的非干酪性肉芽肿	症状
入睡幻觉	症状
多乳房	疾病
长春胺缓释胶囊	药物
更年乐片	药物
卡介菌多糖核酸	药物
胃液胃组织癌胚抗原	检查科目
皮下T细胞淋巴瘤	疾病
枸橼酸喷托维林	药物
复方蛇胆陈皮末	药物
冠心丹参滴丸	药物
法医病理学	NoneType
萘普生	药物
复方猴头颗粒	药物
儿童腹痛	疾病
补体C3免疫扩散板	NoneType
热感清喷雾剂	药物
先天性支气管肺囊肿	疾病
白喉	NoneType
复方甘草酸单铵S氯化钠注射液	药物
异型网织细胞	症状
多发性颅内血肿	疾病
狂犬病人免疫球蛋白	药物
小儿麻痹症	疾病
睾丸微小	症状
抗痨冲剂	药物
复方雷尼替丁颗粒	药物
老年人呼吸衰竭	疾病
替莫唑胺胶囊	药物
焰耳属	NoneType
固经丸	药物
安乃近注射液	药物
理气舒心片	药物
成人生长激素分泌不足	症状
康复灵药膏	药物
枸橼酸舒芬太尼注射液	药物
老年人原发性血小板增多症	疾病
科博肽	NoneType
口服双歧杆菌活菌散剂	药物
炔孕酮片	药物
高热	NoneType
黏稠或脓性痰伴有腥臭味	症状
盐酸吡硫醇片	药物
注射用硫酸小诺霉素	药物
酚氨咖敏片	药物
室颤	疾病
替硝唑葡萄糖注射液	药物
桑枝颗粒	药物
强阳保肾丸	药物
片花耳属	NoneType
脐膨出-巨舌-巨大躯体综合征	疾病
巨脚	症状
毛细血管脆性试验	检查科目
少突胶质细胞瘤	疾病
盐酸芦氟沙星片	药物
消瘦严重者呈”皮包骨头”样	症状
马来酸依那普利	NoneType
水杨酸咪唑片	药物
注射用亚锡二巯丁二钠	药物
鼻前庭皮肤红肿疼痛	症状
延龄长春胶囊	药物
臀中肌损伤	症状
抗核苷酶试验	检查科目
肝畅胶囊	药物
硫柳汞钠	药物
注射用羟基喜树碱	药物
谷氨酸钠	药物
脊髓病变	症状
小儿双磺甲氧苄啶散	药物
口唇干燥	症状
小儿咽扁冲剂	药物
双眼Bell现象不对称	症状
阿帕西林	药物
醋酸环丙孕酮	药物
天门冬氨酸	NoneType
复方玄驹胶囊	药物
纳曲酮	药物
单硝酸异山梨酯分散片	药物
获得性循坏抗凝物质增多综合征	疾病
新生儿肾静脉血栓	疾病
网膜囊肿	疾病
便通片	药物
参柏舒心胶囊	药物
咽痛	NoneType
健脾生血颗粒	药物
氟他胺胶囊	药物
小肠危象	症状
齿痛消炎灵颗粒	药物
接触性口角炎	疾病
梅毒快速血浆反应素诊断试剂	药物
安络痛胶囊	药物
上颌窦恶性肿瘤	疾病
小儿四维钙干混悬剂	药物
失水多于失钠且血清钠浓度高	NoneType
食管息肉	疾病
强肝胶囊	药物
甲芬那酸	药物
加味左金丸	药物
舒安卫生栓	药物
病理性钙化	症状
甘露醇	药物
亚油酸乙酯	药物
持续性发热	症状
金嗓散结胶囊	药物
皮肤黑变	症状
对乙酰氨基酚滴剂	药物
月桂氮卓酮	药物
盐酸特比萘芬	药物
海马三肾丸	药物
新生儿持续性肺动脉高压	疾病
滤泡增大	症状
乳房肉瘤	疾病
瓦松栓	NoneType
胸腺类癌	疾病
尼索地平胶丸	药物
寰椎骨折脱位	疾病
神衰康颗粒	药物
替莫西林	药物
无烟灸条	药物
乳酸亚铁口服液	药物
脑脊液血管活性肠肽	检查科目
脱氧核苷酸钠注射液	药物
芪药消渴胶囊	药物
鳞屑	症状
放射性心脏损害	疾病
乙肝	疾病
乳康丸	药物
孕妇肚子痒	症状
桂圆琼玉颗粒	药物
韧带扭伤	症状
生理性黄疸	疾病
阿替洛尔	NoneType
腹水检查	检查科目
《布鲁氏菌病防治知识	NoneType
葡萄糖酸钙维D2散	药物
中毒性红斑	疾病
硝酸益康唑栓	药物
消积通便胶囊	药物
腹股沟滑动性疝	疾病
强力天麻杜仲胶囊	药物
眼眶蜂窝织炎	疾病
香石双解袋泡剂	药物
鼻渊片	药物
流行性乙型脑炎疫苗	药物
美容	NoneType
小儿白塞病	疾病
参杞全鹿丸	药物
沙眼衣原体和淋球菌核酸扩增(PCR)荧光双检试剂盒	药物
小儿醛固酮过多症	疾病
创伤性口角炎	疾病
布替萘芬	药物
酵母菌	NoneType
疱疹样脓疱病	疾病
眼眶击出性骨折	疾病
克拉霉素片	药物
聚胞苷酸	药物
气体弥散障碍	症状
盐酸舍曲林片	药物
救急散	药物
关节解痛膏	药物
盐酸氯环利嗪	药物
小儿纯红细胞再生障碍性贫血	疾病
济生万应锭	NoneType
复发性多软骨炎性	NoneType
小儿食管化学性烧伤	疾病
胃舒片	药物
女性的青春期延迟	疾病
克林霉素磷酸酯外用溶液剂	药物
土木香十味汤散	药物
玉真散胶囊	药物
冲动毁物	症状
磺胺索嘧啶	药物
谵妄	NoneType
血压为零	症状
炎性细胞浸润	症状
囊性肿块	症状
鼻衂	症状
心房颤动	疾病
洁肤净洗剂	药物
男性生殖器外伤	疾病
八珍液	NoneType
盐酸美西律注射液	药物
麻仁软胶囊	药物
解热镇惊丸	药物
人类免疫缺陷病毒所致葡萄膜炎	疾病
停经并溢乳	症状
甲状腺激素抵抗综合征	疾病
硫酸苯丙胺	药物
肛门或肛管窄小	症状
硫酸卡那霉素	NoneType
甲硝唑泡腾片	药物
肾静脉血栓	疾病
腺样体肥大	疾病
盐酸丁卡因注射液	药物
环维黄杨星D	NoneType
骨友灵巴布膏	药物
假丝酵母	NoneType
产后甲状腺炎	疾病
降糖舒片	药物
纵隔神经鞘源性肿瘤	疾病
双碘喹啉	药物
积液癌胚抗原	检查科目
碰撞后皮肤容易青紫	症状
弥漫性鼓音	症状
盲肠旁疝	疾病
肥胖并痛性结节或脂肪块	症状
盐酸洛贝林注射液	药物
祛风止痛片	药物
依托度酸缓释片	药物
消食健脾丸	药物
鸬鹚涎丸	药物
儿泻止颗粒	药物
长骨骨干结核	疾病
椎-基底动脉盗血综合征	疾病
萘普生钠胶囊	药物
泪液电解质	NoneType
精液少	症状
胆管梗阻	症状
黄芪生脉饮	药物
二甲硅油	NoneType
山茄子清凉颗粒	药物
房事两感症	疾病
肉瘿	疾病
非布丙醇	药物
骨神经纤维瘤	疾病
大便不成形	症状
盐酸雷尼替丁胶囊	药物
胸壁软组织损伤	疾病
急进性肾小球肾炎	疾病
妊娠合并多囊肾	疾病
盐酸左旋咪唑搽剂	药物
戊酸雌二醇	NoneType
妊娠合并血栓性血小板减少性紫癜	疾病
小儿远端肾小管酸中毒	疾病
霰粒肿	疾病
联苯双酯	NoneType
桑椹冲剂	药物
痔速宁胶囊	药物
小儿卡肺囊虫肺炎	疾病
皮肤粘膜色素斑	症状
蚊虫刺咬炎症	疾病
关节囊损伤	症状
恶病性痤疮	症状
盐酸地拉卓胶囊	药物
急性鼻咽炎	疾病
硫酸锌口服液	药物
乳泉颗粒	药物
动眼神经麻痹	症状
突发性聋	疾病
持续性咳嗽	症状
保心片	药物
短骨骨干结核	疾病
健胃消食颗粒	药物
复方多维元素片	药物
黑虎散	药物
单神经病与神经丛神经病	疾病
棘突压痛	NoneType
注射用赖氨匹林	药物
衣鞘	NoneType
肥疮	疾病
甘露糖苷贮积症	疾病
苦参素氯化钠注射液	药物
小儿双解止泻颗粒	药物
盐酸倍他洛尔滴眼液	药物
海南灵芝	NoneType
Ⅳ型肾小管性酸中毒	疾病
冠脉宁	药物
颌骨囊肿	疾病
重组人红细胞生成素	药物
血宁片	药物
化脓性耳廓软骨膜炎	疾病
硫酸长春碱	药物
涎腺结核	疾病
消炎退热胶囊	药物
走川骨刺酊	药物
十一烯酸锌	NoneType
头孢唑兰	药物
维生素K1片	药物
阿那曲唑片	药物
注射用去水卫矛醇	药物
灵芝益寿胶囊	药物
复方海蛇酊	药物
错构瘤	疾病
轻度痛	症状
泪膜消失	症状
洛芬待因	药物
地泊溴铵	药物
痰液中晶体	检查科目
光感性皮肤损害	症状
头孢氨苄缓释片	药物
一侧腰腹突发“刀割”样绞痛	症状
妊娠合并慢性肾上腺皮质功能减退	疾病
呼气时两颊鼓起和缩唇	症状
粪便中见到褐红色果实皮或毛发	症状
七味红花殊胜丸	药物
鼻孔朝天或鼻孔前倾	症状
溴化钠	药物
蛇咬丸	药物
全身毛发呈灰白色	症状
排气多	症状
六味西红花口服液	药物
颌骨膨隆	症状
甘露聚糖肽片	药物
丙酯注射液	药物
血性腹水	症状
卵巢恶性腹膜间皮瘤	疾病
氧氟沙星滴眼液	药物
阵发性室性心动过速	疾病
复方消食冲剂	药物
一粒珠	NoneType
调经益母片	药物
海马巴戟胶囊	药物
小儿急性胰腺炎	疾病
小儿迁延与慢性腹泻	疾病
液状甘油磷酸钾	NoneType
胰高血糖素	NoneType
萘普生分散片	药物
青梅感冒颗粒	药物
尿溶菌酶	检查科目
老年人肥胖症	疾病
特发性水肿	症状
盐酸氯丙那林片	药物
阿昔洛韦颗粒	药物
血清铁蛋白	NoneType
食管恶性病变	症状
顿呛	疾病
注射用盐酸表柔比星	药物
盐酸罗格列酮	药物
脑细胞脱水	症状
肺铁末沉着病	疾病
尿钙	症状
枸橼酸钠抗凝剂	药物
胆脂瘤型中耳炎	疾病
晕血	NoneType
女金片	药物
荆菊感冒片	药物
遗传性铁粒幼细胞性贫血	疾病
复方碳酸钙泡腾片	药物
苄硝唑	药物
生三七粉	NoneType
宫腔粘连	症状
晶状体相关葡萄膜炎	疾病
泌乳素瘤	疾病
尿色酱红或呈酱油色	症状
阿胶	药物
甲苯磺酸舒他西林颗粒剂	药物
产褥中暑	疾病
偏身麻木	症状
喉异物	NoneType
胎心率异常	症状
盐酸硫必利	药物
缺铁性吞咽困难	NoneType
血液保存液I	NoneType
坦度螺酮	药物
固本强身胶囊	药物
妊娠合并甲状腺功能减退	疾病
苯丙氨酸代谢障碍	症状
清肝九味散	药物
金刺参九正合剂	药物
慢性髓细胞白血病	疾病
巨人症与肢端肥大症	疾病
黄氏响声丸	药物
促肝细胞生长素注射液	药物
前臂细小	症状
灼性神经痛	疾病
己酮可可碱氯化钠注射液	药物
异物伤	疾病
去纤酶	药物
茚洛秦	药物
盐酸赖氨酸片	药物
先天性椎体畸形	疾病
维酶素	药物
肺功能衰竭	NoneType
脑血康片	药物
新阿胶	药物
小儿烫伤	疾病
丹皮酚贴膏	药物
乐脉丸	药物
孕妇清火丸	药物
复方红豆杉胶囊	药物
酚氨咖敏颗粒	药物
桥脑出血	症状
盐酸多奈哌齐胶囊	药物
淋菌性肛门直肠炎	疾病
正心泰胶囊	药物
止嗽口服液	药物
牛黄蛇胆川贝胶囊	药物
致死性肝内胆汁淤积综合征	疾病
驳骨风湿酒	NoneType
玫瑰花糖膏	药物
前列安栓	药物
复方三维右旋泛酸钙糖浆	药物
流行性感冒疫苗	药物
嵌顿包茎	疾病
腹部血管杂音	症状
盆腔脊膜膨出	症状
腰椎骶化	症状
甘油果糖	药物
环丙沙星葡萄糖注射液	药物
氟维司群	药物
复方双肼屈嗪片	药物
产细胞毒素幽门螺杆菌抗体酶免检测试剂盒	药物
注射用呋塞米	药物
乳癖消颗粒	药物
健身消导冲剂	药物
细辛脑氯化钠注射液	药物
肾异位血管及副血管	疾病
洛索洛芬	药物
汉肌松注射液	药物
泪腺汗腺及涎腺等先分泌增多而后减少	症状
外感平安颗粒	药物
双黄平喘颗粒	药物
消化道重复畸形	疾病
胃类癌瘤	疾病
复方萘甲唑林喷剂	药物
等渗尿	症状
尿崩症	疾病
睡眠呼吸暂停	症状
慢肾宁合剂	药物
穿山甲	NoneType
小儿腹泻宁糖浆	药物
补中益气颗粒	药物
益心舒片	药物
心肌康颗粒	药物
痛风性心肌病	疾病
肺纹理减少	症状
茵栀黄颗粒	药物
肛门畸形	症状
酮康唑乳膏	药物
滑膜炎颗粒	药物
呈马蜂螫型游走性水肿	症状
白益镇惊丸	药物
梅花点舌丹	药物
硫酸小诺霉素氯化钠注射液	药物
降糖舒	NoneType
酸雾	NoneType
中枢神经系统白血病	疾病
红细胞血清总胆红素	NoneType
盐酸春雷霉素	药物
颈椎椎管狭窄症	疾病
替罗非班	药物
育亨宾	药物
隐匿阴茎	疾病
情感性心境障碍	疾病
乳糜尿定性试验	检查科目
美扑伪麻胶囊	药物
福字阿胶	药物
药物性鼻炎	疾病
阴道裂伤	症状
氟替卡松	药物
颈交感链受累	症状
乙酰谷酰胺注射液	药物
出现毒性颗粒	症状
DF-2败血症的皮肤表现	疾病
间质性膀胱炎	疾病
慢性糜烂性胃炎	疾病
小儿安乃近灌肠剂	药物
骨增生镇痛膏	药物
地霉菌病	疾病
氯氮卓	药物
翠莲解毒片	药物
寒湿痹片	药物
柞蚕蛹脑病	疾病
亚急性硬化性全脑炎	疾病
润肠宁神膏	药物
川黄颗粒	药物
体重减轻	症状
糖尿病	疾病
五仁润肠丸	药物
血脂康胶囊	药物
参茸安神片	药物
板蓝根软胶囊	药物
椎动脉型颈椎病	疾病
枢椎齿突骨折	疾病
乙型肝炎病毒相关性肾炎	疾病
原藻病	疾病
甘油磷酸铁	NoneType
英卡膦酸二钠片	药物
结石通胶囊	药物
婴儿睡觉前哭闹	症状
劳累后心悸	症状
小儿低血糖	疾病
清凉丹	NoneType
硫酸吗啡控释片	药物
鱼肝油软膏	药物
外耳道疼痛	症状
经期前后小腹坠痛	症状
上皮样囊肿	疾病
筋伤宁湿敷剂	药物
子宫内膜间质肉瘤	疾病
扁桃体周围脓肿	疾病
长春地辛	药物
胸段或腰段脊髓伤	症状
右佐匹克隆片	药物
蚓激酶	药物
抗透明质酸酶	检查科目
酒石酸长春瑞滨软胶囊	药物
血红蛋白电泳	NoneType
先天性鼻部皮样囊肿及瘘管	疾病
儿童咳颗粒	药物
利福霉素钠注射液	药物
脑真菌性肉芽肿	疾病
生殖道肿瘤皮肤转移	疾病
皮肤神经瘤	疾病
肺大泡	疾病
外用万应膏	药物
野苏冲剂	药物
酒石酸溴莫尼定	药物
银龙清肝片	药物
握力减退	症状
鼻内似有擤不出的鼻涕	症状
阑尾消炎丸	药物
藤络宁胶囊	药物
老年人尿毒症性肺炎	疾病
雾视	症状
热入血室	疾病
低精蛋白锌胰岛素注射液	药物
京制牛黄解毒片	药物
舌扁桃体肥大	疾病
乙溴替丁	药物
儿童期情绪障碍	疾病
嗜麦芽寡养单胞菌	NoneType
牙齿感觉过敏症	疾病
饭后口淡	症状
性心理不成熟	症状
湿疣	症状
卡介菌素纯蛋白衍生物	NoneType
复方天麻片	药物
胆南星	药物
匹林咖敏片	药物
闭锁综合征	疾病
桉油尿素乳膏	药物
婴儿头皮有黄色结痂	症状
依沙吖啶	药物
闭锁肺综合征	疾病
股后肌劳损	疾病
实火	症状
毛发呈脱发祥	症状
男子雄激素源性秃发	疾病
先天性囊状腺样畸形	疾病
直肠疼痛	症状
气管隆突以上的损伤	症状
上肢及面部血管曲张、水肿及青紫	症状
奥沙普秦肠溶胶囊	药物
联想障碍	症状
胃排空延缓	症状
脸部疼痛	症状
复发性多发性软骨炎伴发的葡萄膜炎	疾病
甘油三酯试剂盒(酶比色法)	药物
西布曲明	药物
功能性胃肠病	疾病
柘木糖浆	药物
血疱	症状
DNA多聚酶	检查科目
齿龈肿胀	症状
四物胶囊	药物
喉切伤	疾病
神经质性格	症状
钠过多	疾病
妙济丸	药物
宫颈复发癌	疾病
铋中毒	疾病
小儿狂犬病	疾病
艾滋病	疾病
妊娠合并获得性免疫缺陷综合征	疾病
老年人原发性肝癌	疾病
大杯伞	NoneType
脑炎样改变	症状
干髓糊	药物
硫鸟嘌呤	药物
保赤散	药物
心包膜发炎	疾病
血友病	疾病
氨苯砜片	药物
儿童腺样体肥大	NoneType
肌苷口服液	药物
肾石症	疾病
风疹病毒	病毒
棘突滑囊炎	疾病
复方柳菊片	药物
急性和亚急性硬脑膜下血肿	疾病
妇科调经颗粒	药物
上颌窦牙源性囊肿	疾病
巴柳氮钠胶囊	药物
阿司匹林双嘧达莫片	药物
厄氏菌属	细菌
糖链抗原50	检查科目
全龟胶囊	药物
阿莫西林胶囊	药物
感愈胶囊	药物
先天性缺额牙	疾病
绞股蓝总甙片	药物
乙状窦血栓性静脉炎	疾病
营养代谢疾病伴发的精神障碍	疾病
新城疫病毒	NoneType
升血灵颗粒	药物
妇炎平胶囊	药物
阿胶三宝膏	药物
躯体或颜面某一局部的连续性抽动	症状
胃气痛片	药物
脾氨肽口服液	药物
锑中毒	疾病
葡萄糖酸亚铁	药物
暖宫孕子丸	药物
五加参精	药物
羊角拗苷	药物
食管腔梗阻	症状
毛状白斑	疾病
小儿猪带绦虫病和囊虫病	疾病
氨基比林咖啡因散	药物
广东神曲	NoneType
十珍香附丸	药物
骨盆痛	症状
门冬酰胺酶	药物
环磷腺苷葡胺葡萄糖注射液	药物
消炎利胆颗粒	药物
阴道转移	症状
甲状腺功能亢进症的肾损害	疾病
经期推迟	症状
功劳去火片	药物
双眼眶距宽	症状
尿钠	药物
希尔德病	疾病
组胺性面红	症状
二氟拉松	药物
苯磺酸氨氯地平胶囊	药物
毒鱼刺伤	疾病
白蔻调中丸	药物
八味西红花清肝热散	药物
嗜酸性粒细胞增多	症状
满山白糖浆	药物
小儿砷中毒	疾病
情绪性癌症	疾病
扎托布洛芬	药物
复方曲尼司特胶囊	药物
氯霉素耳栓	药物
果汁维生素C片	药物
老年人缺血性结肠炎	疾病
胃扭转	疾病
非闭塞性肠系膜血管缺血	疾病
POEMS综合征	疾病
去羟肌苷	药物
吲哚布芬片	药物
川贝止咳糖浆	药物
壮骨止痛胶囊	药物
盐酸金刚烷胺颗粒	药物
追风片	药物
桂附地黄颗粒	药物
手足麻木	NoneType
胸廓出口综合征	疾病
腓总神经损伤	疾病
新生儿心肌炎	疾病
桂龙咳喘宁颗粒	药物
冷球蛋白发生沉淀或呈胶冻状	药物
阿片中毒	疾病
阿德福韦酯片	药物
恶露不净	症状
梅克尔细胞癌	疾病
富马酸依美斯汀滴眼液	药物
健脾补血颗粒	药物
枸橼酸喷托维林滴丸	药物
小支气管痉挛	症状
喘咳宁片	药物
乳果糖浓溶液	药物
左旋咪唑	药物
灵芝北芪片	药物
结核分枝杆菌抗体胶体金法诊断试剂盒	药物
甲状腺功能减退症	疾病
速效心痛滴丸	药物
重酒石酸胆碱	药物
壮阳健威丸	药物
生长缓慢	症状
皮肤或粘膜上附着高锰酸钾结晶	症状
马(羊)抗人IgM荧光抗体	检查科目
硫利达嗪	药物
肩带肌、上肢和胸背部诸肌的肌无力和肌萎缩	NoneType
琥珀酸亚铁缓释片	药物
老年人异位抗利尿素分泌综合征	疾病
胃扭转梗阻症状	症状
胃轻瘫综合征	疾病
磨积散	药物
三维亚铁咀嚼片	药物
盐酸多塞平乳膏	药物
头孢克肟咀嚼片	药物
安胎丸	药物
肠道吸收水分增加	症状
小儿启脾丸	药物
漆所致皮肤病	疾病
直肠内异物	疾病
溴哌利多	药物
氢溴酸高乌甲素	药物
独活寄生合剂	药物
老年人脱水	疾病
实体肿瘤的肾损害	疾病
小儿先天性肾盂输尿管连接部梗阻	疾病
体癣	疾病
参芪益气酒	NoneType
脉络通胶囊	药物
低分子肝素钙注射液	药物
痰液性状	NoneType
继发性红细胞增多症	疾病
西洛他唑	药物
喘舒片	药物
小儿新变异型克罗伊茨费尔特-雅各布病	疾病
复方妥布霉素眼膏	药物
樟脑水合氯醛酊	药物
颅神经麻痹	症状
参芪糖浆	药物
先天性肝纤维化	疾病
无敌止痛搽剂	药物
甘氨酸茶碱钠胶囊	药物
维生素B3	检查科目
闪回	症状
胸膜间皮瘤	疾病
咽部乳头状瘤	疾病
绒毛膜促性腺激素免放药盒	药物
盐酸芦氟沙星胶囊	药物
养血安神颗粒	药物
注射用羟喜树碱	药物
管型尿	症状
过敏性阴道炎	疾病
圆形糠疹	疾病
红细胞压积偏高	症状
三七养血胶囊	药物
谷维素	NoneType
血清皮质醇结合球蛋白	药物
珠芽蓼止泻胶囊	药物
普鲁卡因青霉素	药物
盐酸克仑特罗	药物
抗肌内膜自身抗体	检查科目
盐酸伊达比星	药物
肠囊性积气	症状
心可舒颗粒	药物
复方丹参气雾剂	药物
肛周皮肤有湿疹	症状
白避瘟散	药物
复发性阿弗他溃疡	疾病
玻璃酸钠	药物
青霉素	NoneType
维胺颗粒	药物
海龙胶口服液	药物
复方铁苋止血粉	药物
颌下腺疼痛、压痛	NoneType
复方滋补力膏	药物
益母冲剂	药物
小儿暑感宁糖浆	药物
泪腺混合瘤	疾病
左边脸颊长痘	症状
新生儿消化道重复症	疾病
伪聋	NoneType
玉叶解毒糖浆	药物
习惯性尿裤	症状
手小形方	症状
愈铵异丙嗪口服溶液	NoneType
口涩	症状
老年人阵发性室上性心动过速	疾病
望诊无明显心前区搏动	症状
双丹片	药物
复方盐酸克仑特罗胶丸	药物
蜂胶牙泰	药物
复方甘氨酸茶碱钠胶囊	药物
晶状体蛋白过敏性青光眼	疾病
低钙腹膜透析液	NoneType
儿童不敢平卧睡觉	症状
晚发月经	症状
伤科活血酊	药物
阿柔比星	药物
决明山绿茶	药物
保济油	药物
弥漫性腹部骨化	症状
口腔颌面部软组织动物咬伤	疾病
饱食后胸痛	症状
洛美沙星	药物
麝香舒活灵	药物
祖卡木颗粒	药物
无胆汁粪便	症状
阿尼普酶	药物
白树油	NoneType
肢体或躯干麻木	症状
食管过短	疾病
蕲蛇药酒	药物
十全大补丸	药物
全身消瘦型	症状
茶苯海明含片	药物
甲丙氨酯	药物
神经性耳聋	疾病
独一味片	药物
关节松弛	症状
阿司咪唑片	药物
聚卡波非	药物
眼睑丹毒	疾病
苦参碱注射液	药物
磺胺脒片	药物
皮肤发黄但巩膜没有黄染	症状
外阴汗腺腺癌	疾病
益肝灵片	药物
口形红细胞增多症	疾病
己酮可可碱肠溶片	药物
获得性视网膜大动脉瘤	疾病
手术后和创伤后肺炎	疾病
法莫替丁散	药物
腹外疝	疾病
赖氨匹林颗粒剂	药物
脂清胶囊	药物
行为紊乱而奇特	症状
静脉出血	症状
尿液氨水味	症状
越鞠片	药物
己烯雌酚片	药物
灵砂	药物
度洛西汀	药物
不完全性房内阻滞	症状
复方头孢克洛片	药物
图形定向障碍	症状
颈部开放性损伤	疾病
玉竹膏	药物
粪中细胞	检查科目
牛黄清心丸(局方)	药物
左心发育不良	疾病
尿黄体生成素	检查科目
消银片	药物
托西溴苄铵	NoneType
桂灵丸	药物
茵陈酒	NoneType
肝结核	疾病
盐酸利多卡因注射液	药物
盐酸二甲双胍胶囊	药物
氯化钴	药物
温经养血合剂	药物
复方地巴唑氢氯噻嗪胶囊	药物
珠芽蓼止泻颗粒	药物
前斜角肌肥厚痉挛	症状
老年人低血压	疾病
气管炎丸	药物
金鸡片	药物
克比热提片	药物
眉毛外侧脱落稀疏而细	症状
感冒解热片	药物
双价肾综合征出血热纯化疫苗	NoneType
血管网状细胞瘤	疾病
瞳孔异常	症状
达托霉素	药物
小儿窦性心律失常	疾病
获得性免疫缺陷综合征的消化系统损害	疾病
心率过缓	症状
消咳平喘口服液	药物
产黄纤维单胞菌	NoneType
荨麻疹	疾病
药物性狼疮	疾病
近视散光	症状
子宫收缩过强	疾病
白渣样鼻涕	症状
丁香酚	药物
盐酸苯环壬酯片	药物
盐酸氨溴索糖浆	药物
杞菊地黄丸	药物
五维他口服溶液	药物
光线性弹力纤维病	疾病
先天性弓形体	症状
口腔幻触	症状
自身溶血试验	检查科目
脉络膜脱离	疾病
维生素U	NoneType
北埔陷纹金龟	NoneType
铝碳酸镁咀嚼片	药物
鹅去氧胆酸胶囊	药物
食管病	疾病
对乙酰氨基酚泡腾颗粒	药物
螺旋形骨折	症状
盐酸戊乙奎醚	药物
补肾助阳丸	药物
心脏转移瘤	疾病
盐酸吗啡	药物
血睾酮降低	症状
产后益母丸	药物
灯盏花颗粒	药物
带症丸	药物
生脉片(党参方)	药物
牛胆酸钠	药物
消毒弹性创可贴	NoneType
轴性遗忘症	疾病
反应性穿孔性胶原病	疾病
甲磺酸双氢麦角碱片	药物
桂圆琼玉冲剂	药物
炎琥宁	药物
顽固性高血压	症状
石榴健胃丸	药物
参芪鱼肝油凝胶	药物
非凹陷黏液水肿	症状
西拉普利	药物
谷胱甘肽S转移酶	检查科目
单眼双下转肌麻痹	疾病
乙氧黄酮	药物
咳喘安口服液	药物
对多脂饮食不能耐受	症状
Howship-Romberg征	症状
青霉素V钾分散片	药物
贲门黏膜撕裂综合征	疾病
颈椎后纵韧带骨化症	疾病
泌尿系感染	NoneType
葡萄糖-6-磷酸脱氢酶缺乏症	疾病
指甲上起小细粒	症状
罗红霉素干混悬剂	药物
糠甾醇片	药物
腱反射异常	症状
甲磺酸瑞波西汀	药物
益心巴迪然吉布亚颗粒	药物
姜胆咳喘片	药物
消瘰夏枯草膏	药物
复方凤胆口服液	药物
糖链抗原125	检查科目
前列腺肉瘤	疾病
幽门肿块	症状
并指畸形	疾病
四维王浆葡萄糖颗粒	药物
复方百部止咳冲剂	药物
网织红细胞生成指数	NoneType
下肢红斑结节	症状
气短	症状
肠球菌	病毒
神经伤	症状
微达康颗粒	药物
感染性鼻炎	疾病
停止排气	症状
喹乙宗	药物
注射用盐酸伊达比星	药物
恶息、多泡味的白色粪便	NoneType
复方氢化可的松胶布	药物
子宫颈黏液检查	检查科目
狐臭	疾病
肿痛安胶囊	药物
四味光明盐汤散	药物
伤寒面容	症状
碘塞罗宁	药物
新力正骨喷雾剂	药物
哌替啶	药物
心脏损伤	NoneType
蹄鞘胶囊	药物
牙周炎	疾病
单纯性晕厥	症状
肝叶萎缩	症状
仙灵骨葆片	药物
复方盐酸异丙肾上腺素气雾剂(混悬型)	药物
依替膦酸二钠胶囊	药物
牛病毒性腹泻病毒	NoneType
股骨颈骨折	疾病
妊娠合并重症肌无力	疾病
搏动性头痛	症状
依诺沙星软膏	药物
止血镇痛胶囊	药物
可待因桔梗片	药物
第1跖趾骨关节炎	疾病
情绪性感冒	症状
瘀血	症状
盐酸利托君	药物
经行流涎	疾病
滑石粉尘肺	疾病
新生儿黄疸	NoneType
达肺草	药物
食管对称性膨大	症状
脊神经压迫	症状
头枕部慢性疼痛	症状
吡贝地尔	药物
蚕茸柱天胶囊	药物
胃益胶囊	药物
米贝拉地尔	药物
无菌性肋软骨炎	疾病
瑞格列奈	药物
耳烧伤	疾病
盐酸甲氯芬酯胶囊	药物
苯甲醇	NoneType
缩泉胶囊	药物
免疫力下降	症状
逸搏出现	症状
风疹病毒抗体	检查科目
森林脑炎	疾病
频繁吐黏液	症状
阿莫西林片	药物
喘可治注射液	药物
氯普唑仑	药物
阿法双酮	药物
注射用甲磺酸罗哌卡因	药物
益气维血片	药物
膀胱气痛	疾病
葡萄胎	疾病
双氯非那胺	药物
半夏天麻丸	药物
金龙舒胆胶囊	药物
胸部长痘	症状
杞药消渴口服液	药物
小儿有机磷农药中毒	疾病
粪胆原	NoneType
月经期间腰疼	症状
维生素E粉	药物
鞣酸	NoneType
炔诺酮	药物
朗格汉斯组织细胞增多症	疾病
降脂宁颗粒	药物
乳腺脂肪肉瘤	疾病
蝶骨嵴脑膜瘤眼部病变	疾病
复方夏天无片	药物
炔诺孕酮炔雌醚	药物
间歇性寒颤	症状
异常血红蛋白病	疾病
髌骨软化	症状
骨髓有核细胞总数	NoneType
迪格奥尔格综合征	疾病
阴茎离断伤	疾病
虹膜新生血管	疾病
手癣	疾病
复方感冒灵胶囊	药物
试管婴儿	疾病
原发性甲状腺恶性淋巴瘤	疾病
前列腺液中淀粉样体	NoneType
益血晶颗粒	药物
天麦消渴片	药物
对氨基水杨酸钠	药物
氨苯蝶啶片	药物
解毒止泻胶囊	药物
肠杆菌	病毒
甲状旁腺机能减退	NoneType
硬皮病食管	疾病
静止性淋巴细胞性甲状腺炎	疾病
感冒止咳胶囊	药物
HBV与HCV重叠感染	症状
髌股关节软骨损伤	疾病
卡普兰综合征	疾病
伏脉	症状
葡萄球菌	症状
婴儿指趾纤维瘤病	疾病
聚甲丙烯酸铵酯	NoneType
盐酸氨溴索	药物
肛周脓肿	症状
复肝宁胶囊	药物
宫寒	疾病
虚寒胃痛颗粒	药物
胃肠道功能不好	症状
消银胶囊	药物
舒张期震颤	症状
肝舒片	药物
磺胺间甲氧嘧啶	药物
苏云金芽孢杆菌	药物
游离三碘甲状腺原氨酸放射免疫分析药盒	药物
脊柱裂和有关畸形	疾病
拔毛狂	疾病
跖骨、趾骨骨折	疾病
猪苓多糖胶囊	药物
胆汁性肝硬化	疾病
干胁痛	症状
骶尾椎融合	症状
妇乐冲剂	药物
己酮可可碱葡萄糖注射液	药物
小儿基底细胞痣综合征	疾病
玉屏风胶囊	药物
盐酸洛美利嗪片	药物
朗汉斯细胞的组织细胞增多症	疾病
坐骨直肠窝脓肿	疾病
左胸痛	症状
Graves病	疾病
重度肥胖	症状
槐定碱	NoneType
复方芦荟胶囊	药物
四香祛湿丸	药物
复方补骨脂颗粒	药物
布比卡因	药物
军团菌病	疾病
十灰散	药物
皮肤颌口虫病	疾病
妊娠合并心室间隔缺损	疾病
晕可平糖浆	药物
伤痛宁膏	药物
注射用重组人II型肿瘤坏死因子受体抗体融合蛋白	药物
枸橼酸钙	药物
老年大便失禁	疾病
维生素A缺乏病	疾病
三氯叔丁醇	药物
心脑静片	药物
克咳片	药物
前庭神经受损	症状
畸形中央尖	疾病
复方杜仲胶囊	药物
休克	疾病
脓毒性血栓	症状
皮下脂肪肉芽肿	疾病
二羟基苯磺酸钙	药物
筋骨痛消丸	药物
唾液中的细胞	检查科目
沙丁胺醇口腔崩解片	药物
抱癖	症状
老年人支原体肺炎	疾病
盐酸米安色林片	药物
阑尾肿瘤	疾病
再生障碍性贫血	疾病
镰状细胞贫血	疾病
坎地沙坦酯片	药物
先天性血管萎缩性皮肤异色症	疾病
碘海醇注射液	药物
耳源性破伤风	症状
头孢特仑	药物
脐残端有少量黏液或脓性分泌物	症状
多房棘球蚴病	疾病
出现喉结	症状
蝎杞酒	NoneType
硫酸软骨素A钠	药物
精神障碍	症状
性交晕厥	NoneType
手足徐动性脑瘫	疾病
参柴肝康片	药物
热毒平颗粒	药物
月经量少	疾病
网络成瘾	疾病
肝血管肉瘤	疾病
新生儿衣原体感染	疾病
溴己氨胆碱	药物
性受虐癖	症状
二溴海因	药物
吲达帕胺胶囊	药物
腹壁切口疝	疾病
当归补血胶囊	药物
碳酸锂缓释片	药物
澳泰乐颗粒	药物
男子性功能障碍	症状
四肢震颤	症状
阳春玉液	药物
清咽利膈丸	药物
氢氧化钙糊剂	药物
软纤维瘤	疾病
注射用乙酰谷酰胺	药物
肉痹	NoneType
盐酸替扎尼定片	药物
醋酸可的松滴眼液	药物
小儿常染色体显性小脑性共济失调	疾病
桔红丸	药物
逼尿肌无反射	症状
血小板寿命缩短	症状
布氏杆菌红斑	疾病
逐瘀通脉胶囊	药物
红细胞葡萄糖磷酸异构酶	检查科目
心跳很乱	症状
脑出血	疾病
加味逍遥丸	药物
热带性出汗不良	疾病
口角皲裂	症状
良性溃疡改变	症状
子满	疾病
优尼	药物
注射用亚锡葡庚糖酸钠	药物
温结节	症状
血管紧张素	NoneType
先天性眼睑缺损	疾病
肠壁水肿增厚	症状
单纯性牙周炎	疾病
培哚普利吲达帕胺片	药物
大脑发育障碍	症状
紫金锭	药物
外伤性颈内动脉海绵窦瘘	疾病
哈拉宗片	药物
强硬舌	症状
指纹皱瘪	症状
桂美酸	药物
声带小结	疾病
脾良性肿瘤	疾病
吞噬功能缺陷病	疾病
罗哌卡因	药物
带下病	疾病
血红蛋白尿	症状
复方苯佐卡因凝胶	药物
枫蓼肠胃康胶囊	药物
迟发性运动障碍	NoneType
小儿急性中毒性脑病	疾病
乙脑伴发的精神障碍	疾病
榕敏颗粒	药物
香果健消片	药物
溴隐亭	药物
食管贲门黏膜撕裂综合征	疾病
暴怒	症状
手足脱皮	症状
参茸保胎丸	药物
利巴韦林滴鼻液	药物
注射用盐酸多巴胺	药物
髌骨劳损	NoneType
佐匹克隆胶囊	药物
安钠咖注射液	药物
里尔黑变病	疾病
骨母细胞瘤	疾病
乏力	症状
小儿血管骨肥大综合征	疾病
胆胃康胶囊	药物
利巴韦林分散片	药物
辗转体位	症状
丹萸片	药物
康脉益心片	药物
筛窦泪囊瘘	症状
青春期厌食症	疾病
金属性变色	疾病
咽结合膜热	疾病
盐酸布替萘芬	药物
不协调性兴奋	症状
吡唑酮类中毒	疾病
鼻窦炎	疾病
打鼾	症状
直肠内套叠	疾病
参茸补血酒	药物
环香豆素	药物
消瘀降脂胶囊	药物
溶血尿毒症综合征	疾病
蛤蚧补肾胶囊	药物
布洛伪麻片	药物
并殖吸虫后尾蚴膜反应	检查科目
卵巢硬化性间质瘤	疾病
克林霉素磷酸酯凝胶	药物
溴米因注射液	药物
消痔灵片	药物
肺部可闻及干湿啰音及哮鸣音	症状
心力贮备减少	NoneType
聚维酮	药物
绵羊抗兔血清	NoneType
骨核出现迟，发育小	NoneType
小儿阅读障碍	疾病
头孢替唑	药物
千紫红颗粒	药物
萝藤安神片	药物
睾丸扭转	疾病
细菌性阴道病	疾病
乙型肝炎病毒表面抗体诊断试剂盒	药物
祛瘀益胃胶囊	药物
炎立消胶囊	药物
化脓性乳腺炎	疾病
纵隔阴影	症状
盐酸昂丹司琼氯化钠注射液	药物
陇马陆胃药片	药物
收缩压下降	NoneType
小细胞肺癌	疾病
万年春酒	NoneType
复方碳酸钙泡腾颗粒	药物
沙眼衣原体	检查科目
谷氨酸	NoneType
代谢综合征	疾病
苦参素	药物
男性特纳综合征	疾病
人参益母丸	药物
益气补血片	药物
门冬氨酸镁	药物
阿米巴痢疾	疾病
复方盐酸阿米洛利片	药物
苦参碱氯化钠注射液	药物
酒石酸铋	药物
对氨基水杨酸异烟肼片	药物
脑血栓	疾病
茵栀黄注射液	药物
益视颗粒	药物
小儿中耳炎	疾病
中心静脉压偏高	症状
老年人免疫性血小板减少性紫癜	疾病
止血灵胶囊	药物
高锰酸钾外用片	药物
远志滴丸	药物
脉速而无力	症状
盐酸阿夫唑嗪缓释片	药物
维A酸片	药物
辽源七厘散	药物
三溴片	药物
普济痔疮栓	药物
更昔洛韦胶囊	药物
颅内肿瘤伴发的精神障碍	疾病
食物在胃的通过障碍	症状
氢溴酸西酞普兰片	药物
甲磺酸倍他司汀片	药物
膀胱鳞状细胞癌	疾病
他舒辛	药物
耳后乳突水肿	症状
思维控制异常	NoneType
葡萄膜病	疾病
止咳桃花胶囊	药物
骨髓炎	疾病
功能性头痛	NoneType
合成鱼腥草素片	药物
口腔颌面部核武器伤	疾病
充血性脾肿大	症状
五氟利多	药物
维生素E烟酸酯	药物
阿司匹林咀嚼片	药物
食管狭窄	症状
苦栀颗粒	药物
安胃止痛散	药物
归芪颗粒	药物
过敏性支气管肺曲霉病	疾病
银屑胶囊	药物
狗皮膏	药物
脂蛋白肾小球病	疾病
盐酸乙哌立松颗粒	药物
热毒平胶囊	药物
周身炎症反应	症状
鼻翼扇动	症状
米他氯铵	药物
十一酸睾酮注射液	药物
寿星补汁	药物
生物元素	NoneType
妇科养荣丸	药物
冻干组织胺人免疫球蛋白	药物
口鼻清喷雾剂	药物
早产	NoneType
下颈椎不稳症	疾病
椎动脉创伤性栓塞	疾病
保心宁片	药物
颊癌	疾病
头部及眼后部疼痛并能听到连续不断的隆隆声	症状
银冰消痤酊	药物
舒筋风湿酒	NoneType
肺弥散功能障碍	症状
脑乐静胶囊	药物
褐球固氮菌	NoneType
注射用三磷酸腺苷二钠	药物
沉香降气丸	药物
肝母细胞瘤	疾病
先天性卵巢发育不全	疾病
罗汉果玉竹冲剂	药物
头孢拉定片	药物
脑脊液蛋白电泳	检查科目
大黄庶虫丸	药物
剧烈运动后腰痛	症状
弓形虫点免疫金渗滤法	NoneType
玄夏祛毒胶囊	药物
癌性发热	症状
普伐他汀	药物
振源片	药物
发作性不自主运动	症状
女子梦交	疾病
东莨菪碱	药物
清肝毒胶囊	药物
爱德华氏菌	NoneType
气管移位	症状
生长激素分泌过少	症状
戊酸雌二醇注射液	药物
脊柱退变	症状
风湿骨康片	药物
食管气管瘘	症状
咽部神经鞘膜瘤	疾病
玄麦甘桔胶囊	药物
反复感冒	症状
肱骨上端骨骺分离	疾病
伸膝障碍	症状
眼部毛细血管瘤	疾病
干燥综合征	疾病
恒制咳喘胶囊	药物
蜂胶口腔膜	药物
乳康颗粒	药物
进行性肌麻痹	症状
甲砜霉素片	药物
苯扎氯铵溶液	药物
非细菌性血栓性心内膜炎	疾病
突肤挺胸	症状
组织胞浆菌病	疾病
原发性小肠淋巴管扩张症	疾病
甲亢丸	药物
早搏	疾病
洁霉素片	药物
苯海拉明中毒	疾病
模仿性自动症	疾病
氢溴酸右美沙芬	NoneType
更年期抑郁	症状
皮肤上线状排列的小水疱伴发疼痛	症状
酚磺乙胺氯化钠注射液	药物
唾液白蛋白	检查科目
复方红根草片	药物
老年人流泪多	症状
洋参保肺口服液	药物
阵发性室上性心动过速	疾病
五味清浊丸	药物
盆底腹膜疝	疾病
进行性肉芽性溃疡坏死	症状
磺胺嘧啶钠	药物
结核性巩膜炎	疾病
腹型癫痫综合征	疾病
眼眶神经鞘瘤	疾病
舌苔发黑	症状
脑脊液环磷腺苷	检查科目
复春片	药物
小腿和踝关节周围的紫红色瘀斑	症状
日舒安洗液	药物
胃超声显像液	NoneType
扁桃体癌	疾病
咽炎含片	药物
鳞屑样痂皮	症状
苯扎托品	药物
房性逸搏心律加速	NoneType
布氏杆菌病	疾病
大量饮酒后突然视力减退	症状
白秃疮	疾病
盐酸哌替啶片	药物
暴牙	症状
女性膀胱颈梗阻	疾病
注射用谷氨酸诺氟沙星	药物
鼻梁低	症状
速感宁胶囊	药物
椎节后缘有骨刺形成	症状
腹主动脉动脉瘤破裂	疾病
复方矮地茶片	药物
碳酸氢钠片	药物
松石丸	药物
益气复脉口服液	药物
虫积	NoneType
小儿赖氏综合征	疾病
咽部有异物感	症状
感冒清解颗粒	药物
硫酸钠	药物
活络丸	药物
小肠结肠炎耶尔森菌肺炎	疾病
吉非替尼	药物
氨甲苯酸注射液	药物
硫普罗宁肠溶片	药物
小儿复方氨酚烷胺片	药物
胆囊癌	疾病
曲吡那敏	药物
复方地塞米松乳膏	药物
托烷司琼	药物
骨筋丸胶囊	药物
格列本脲片	药物
珍珠末	药物
电脑病	疾病
宫角妊娠	疾病
地匹福林	药物
复方萘甲唑啉喷剂	药物
带状疱疹	NoneType
硫酸亚铁缓释片	药物
麝香追风膏	药物
健儿止泻颗粒	药物
异尖线虫病	疾病
腹膜透析液(乳酸型)	NoneType
腹膜后疝	疾病
复方维生素B注射液	药物
长春碱	药物
乳酸盐腹膜透析液	NoneType
溶栓胶囊	药物
肾包膜过度膨胀	症状
复方风湿宁注射液	药物
脱疽	NoneType
囊痈	疾病
感冒解毒灵颗粒	药物
百令颗粒	药物
黄连羊肝片	药物
神经节苷酯	药物
子宫脱垂	疾病
胸腰驼背	症状
宫颈前唇水肿	症状
肺不发育或发育不全	疾病
复方珍珠解毒口服液	药物
小儿幽门螺杆菌感染	疾病
盐酸克林霉素阴道泡腾片	药物
龟茸壮骨片	药物
追风丸	药物
汗管棘皮瘤	疾病
古汉养生精	药物
足趾皮肤发黑	症状
牙冠呈半透明乳光色	NoneType
甘油	NoneType
烧心	症状
替米沙坦	药物
扑米酮	药物
雄激素依赖	症状
复方氨基酸(8)维生素(11)胶囊	药物
灵益胶囊	药物
闭合性气胸	疾病
复方甘草酸苷注射液	药物
吲达帕胺片	药物
痉挛性脑瘫	疾病
醋酸地塞米松注射液	药物
心室内传导阻滞	疾病
阿司匹林锌	NoneType
葡萄球菌中毒性休克综合征	疾病
肾舒冲剂(无糖型)	药物
铁娃散	药物
卵巢破裂	疾病
天门冬氨酸洛美沙星葡萄糖注射液	药物
参鹿补虚胶囊	药物
甲磺酸瑞波西汀片	药物
珠珀安神丹	药物
回旋状脉络膜视网膜萎缩	疾病
休克较久后的肺部病变	症状
中满分消丸	药物
枯草芽胞杆菌	NoneType
通宣理肺颗粒	药物
盐酸喹那普利	药物
胰岛素瘤	疾病
碘肽钠	药物
共同性斜视	疾病
卡巴胆碱	药物
两条腿不一样长	症状
皮肤瘀点	症状
维他利匹特	药物
麝香接骨胶囊	药物
胸部丝虫病	疾病
脊髓出血	症状
副神经损伤与卡压	疾病
小儿尤因肉瘤	疾病
小儿双磺甲氧苄啶颗粒	药物
复方氯霉素栓	药物
碘曲西葡胺	药物
骨痨敌注射液	药物
复方半夏片	药物
长春益寿膏	药物
大麻风丸	药物
头孢唑南	药物
弧菌	细菌
非器质性冷阴	疾病
愈创木酚甘油醚	药物
参麦注射液	药物
叶绿素铜钠乳膏	药物
血清脂蛋白和血清脂蛋白电泳	检查科目
氯芬那酸	药物
奥硝唑葡萄糖注射液	药物
外阴-阴道-牙龈综合征	疾病
虫咬皮炎	疾病
白痢	疾病
双黄连胶囊	药物
非结核性分枝杆菌病	疾病
反社会人格障碍(病态人格)	疾病
甲硝唑葡萄糖注射液	药物
眼眶骨瘤	疾病
阿法骨化醇软胶囊	药物
盐酸左旋咪唑颗粒	药物
原发性腮腺淋巴瘤	疾病
多西环素	药物
脉管畸形	疾病
固元片	药物
血管萎缩性白斑	症状
金樱子膏	药物
先天性腹膜疝	疾病
橘红化痰片	药物
漏斗骨盆	症状
氧化锌	药物
纤维结构不良	症状
灰平链霉菌SF-17	NoneType
熊猫眼	症状
金果钦	NoneType
耳后骨膜下脓肿	疾病
消旋卡多曲片	药物
癫痫伴发的神经症	疾病
复方鸡骨草胶囊	药物
金银花口服液	药物
右边脸颊长痘	症状
抗丙型肝炎病毒IgA抗体	检查科目
胃粘膜呈萎缩性改变	症状
浆液脓性分泌物	症状
非普拉宗片	药物
毛霉病	疾病
炎痢净片	药物
复方甲麻口服溶液	药物
鼻窦鳞状细胞癌的眼部病变	疾病
桔梗流浸膏	药物
四维他片	药物
吲哚美辛	NoneType
蚓激酶肠溶片	药物
非布丙醇胶丸	药物
小儿淹溺	疾病
乙胺硫脲	NoneType
复方硫酸双肼屈嗪片	药物
大肠湿热	疾病
血清脯氨酸羟化酶	NoneType
伴有生动鲜明的恐怖性幻视	症状
B淋巴细胞表面标志	检查科目
皮肤阿米巴病	疾病
宁泌泰胶囊	药物
肠舒片	药物
金疮	疾病
巨脑回畸形	疾病
广泛红斑浸润损害伴有脱屑	症状
进食障碍	NoneType
痰液颜色	NoneType
阴疮	NoneType
老年人血管性痴呆	疾病
蜘蛛痣	NoneType
软骨发育不良与骨骼畸形	症状
齐多夫定	NoneType
银柴颗粒	药物
更年舒片	药物
棒状杆菌属	细菌
普伐他汀钠	药物
芎香通脉丸	药物
股骨头骨骺骨软骨病	疾病
益肝活血明目丸	药物
地奥心血康片	药物
洋地黄毒甙片	药物
复方马勃水杨酸散	药物
日常生活能力减退和行为异常	NoneType
喉痛片	药物
磷酸二氢钠	药物
二十五味绿绒蒿胶囊	药物
残胃淋巴瘤	疾病
吡喹酮片	药物
肺癌胸水	症状
延枳丹胶囊	药物
三果汤口服液	药物
芬戈莫德	药物
氨酚比林注射液	药物
柴黄清热颗粒	药物
盐酸托哌酮胶囊	药物
消咳宁片	药物
开放性损伤	NoneType
心痛康胶囊	药物
银杏酮酯滴丸	药物
己酮可可碱	药物
湿疹散	药物
养正消积胶囊	药物
尿道癌	疾病
卡替洛尔	药物
发烧	NoneType
长期的盆腔疼痛	症状
赤丝虬脉	疾病
血道播散	药物
复方芦荟维U片	药物
注射用氧氟沙星	药物
保妇康栓	药物
牙龈炎	疾病
女性第二性征消失	症状
消渴降糖胶囊	药物
碘酸钾片	药物
人参滋补膏	药物
淀粉酶同工酶	NoneType
枸橼酸乙胺嗪	药物
正清风痛宁片	药物
麻杏止咳糠浆	NoneType
盐酸头孢他美酯	药物
氨基比林咖啡因片	药物
盐酸罗通定片	药物
盐酸二甲双胍	药物
唾液碳酸氢盐	检查科目
感冒通片	药物
乳酸蓄积过多	症状
血吸虫虫卵抗体诊断试剂盒(酶联免疫法)	药物
双金连合剂	药物
五维赖氨酸口服液	药物
依帕司他	药物
济生肾气丸	药物
乳糖酸克拉霉素胶囊	药物
腰椎椎管狭窄	症状
妇炎净片	药物
消肿痔疮片	药物
眼部感染	症状
盐酸丁咯地尔	药物
银屑病关节炎及其伴发的葡萄膜炎	疾病
鼻子红血丝	症状
啤酒酵母	NoneType
踝部及足背水肿	症状
盐酸	药物
小儿双清颗粒	药物
独活寄生颗粒	药物
奥硝唑分散片	药物
复方硫酸氢黄连素软膏	药物
尿道瘘	症状
诺迪康颗粒	药物
甲胎蛋白诊断试剂盒(酶联免疫法)	药物
归芍地黄丸	药物
磷酸可待因糖浆	药物
鹭鸶咯丸	药物
氯硝西泮注射液	药物
婴儿睡觉惊跳	症状
自体敏感性湿疹	疾病
吗氯贝胺片	药物
土霉素软膏	药物
聚维酮碘栓	药物
水泻伴低血钾	症状
盆腔瘀血	症状
骨筋丸片	药物
乌阳补心糖浆	药物
汉字应用水平测试命题	NoneType
头葡萄球菌	NoneType
自养假诺卡氏菌	NoneType
白药胶囊	药物
病理性赌博	症状
小儿喉痉挛	疾病
食管失弛缓症	疾病
心跳加快	症状
血栓性浅静脉炎	疾病
管状腺瘤	疾病
右旋糖酐40	NoneType
免疫介导性肾脏病	疾病
眶周瘀斑	症状
复方颠茄氢氧化铝片	药物
胃纳呆滞	疾病
深侧鼻塞	症状
眉毛变白	症状
联合瓣膜脱垂	症状
复方磷酸可待因	药物
冷汗	症状
长春胺	药物
注射用门冬氨酸阿奇霉素	药物
传染性支气管炎病毒	NoneType
急性出血性结膜炎	疾病
白芍总苷	药物
小儿伯-韦综合征	疾病
慢肝宁胶囊	药物
克兰费尔特综合征	疾病
血浆结合球蛋白半定量测定	药物
失钠多于失水且血清钠浓度低	NoneType
骨髓增生性疾病	疾病
玉屏风口服液	药物
筒箭毒碱	药物
肝精补血素口服液	药物
冰黄软膏	药物
骨髓象左移现象	症状
小儿珠蛋白生成障碍性贫血	疾病
婴儿睡觉摇头	症状
顺气十三味散	药物
复方锌铁钙颗粒	药物
可可钙糖片	药物
补肾益脑丸	药物
丙胺卡因	NoneType
铀同位素	NoneType
接合菌病	疾病
多维元素片(21)	药物
肺铝土纤维化	疾病
注射用吗替麦考酚酯	药物
普乐安胶囊	药物
小儿卵巢肿瘤	疾病
皮尔松丝膜菌	NoneType
女性尖锐湿疣	疾病
复方硝酸甘油片	药物
噙化上清片	药物
左侧卧时右腰呈空音，右侧卧时左腰呈浊音	NoneType
匙状指（趾）	NoneType
流行性出血热诊断红细胞	NoneType
复方夏枯草降压糖浆	药物
胃重复畸形	NoneType
美舒仿	药物
恶寒发热	NoneType
包头市传染病防治条例	NoneType
喃喃重复自语	NoneType
盐酸哌甲酯片	药物
腰肌痉挛	症状
双羟萘酸噻嘧啶片	药物
脓肿破入胸腔	症状
阿加曲班	药物
胃欣舒胶囊	药物
神经性肌强直	疾病
小儿普通易变型免疫缺陷	疾病
酸蚀症	疾病
江苏省心理学会	NoneType
肛周湿疹	疾病
众生丸	药物
肌腱粘连	症状
维甜美降糖茶	药物
儿童清肺口服液	药物
百花定喘片	药物
铅中毒	疾病
氨甲环酸注射液	药物
痤疮丙酸杆菌	NoneType
冠心泰丸	药物
柔肝顺气丸	药物
止咳枇杷糖浆	药物
肩臂外侧的感觉障碍和功能受限	NoneType
糜蛋白酶	药物
创伤性心源性溶血性贫血	疾病
双侧肾上腺皮质增生	症状
注射用培美曲塞二钠	药物
胆红素钙结石	症状
性病相关性胃肠道感染	疾病
孕妇气喘	症状
拇指掌指关节尺侧侧副韧带损伤	疾病
双氯芬酸钠肠溶片	药物
视网膜动脉阻塞	疾病
硝酸咪康唑乳膏	药物
杜仲壮骨丸	药物
盐酸氟西汀胶囊	药物
外阴瘙痒	疾病
连蒲双清片	药物
齐多夫定口服溶液	药物
非特异性尿道炎	疾病
甲基斑蝥胺	药物
单硫酸卡那霉素颗粒	药物
日光性雀斑样痣	疾病
疏风活络片	药物
马来酸替加色罗	药物
痛觉与温度觉减退而压觉存在	症状
射精疼	症状
阿根廷出血热	疾病
重度痛	症状
老年性睑外翻	疾病
妇炎康复颗粒	药物
直立性低血压晕厥	症状
血清谷丙转氨酶	检查科目
原发性腹膜后肿瘤	疾病
黏膜损害	症状
皮质功能减退	NoneType
慢性纤维性甲状腺炎	疾病
强酸类中毒	疾病
肘外侧肿痛及功能障碍	症状
咳嗽伴体重减轻	症状
鼻咽癌的眼部病变	疾病
磷酸丙吡胺	药物
追风药酒	药物
乳酸环丙沙星	药物
维生素K	药物
甲状腺球蛋白放射免疫分析药盒	药物
乳块消胶囊	药物
乳腺癌皮肤转移	疾病
知柏地黄胶囊	药物
擦癣药水	药物
盐酸异麻黄碱	药物
皮壳烟链霉菌	NoneType
青光眼斑	症状
小儿七星茶冲剂	药物
诊断室中所测血压始终增高	症状
神衰康胶囊	药物
盐酸非索非那定片	药物
西维美林	药物
脑脊液葡萄糖和血清葡萄糖比值	NoneType
加味烂积丸	药物
醒脑降压丸	药物
口腔颌面部软组织挫伤	疾病
培元通脑胶囊	药物
沉香利气丸	药物
加压素	药物
注射用草乌甲素	药物
小腿水肿	症状
腘动脉破裂	疾病
醋酸曲安奈德软膏	药物
血清脂肪酶	NoneType
振源胶囊	药物
牙龈癌	疾病
莨菪浸膏片	药物
口炎	疾病
尿酸代谢亢进	症状
尾蚴性皮炎	疾病
苏肝合剂	药物
盐酸奈福泮	药物
卡铂	药物
美愈伪麻胶囊	药物
大网膜肿瘤	疾病
单发性骨软骨瘤	疾病
青海麝香膏	药物
健康补脾丸	药物
六味安消胶囊	药物
胫骨假关节形成	症状
倍他米松新霉素乳膏	药物
布洛芬片	药物
注射用尤瑞克林	药物
脊髓灰质炎病毒分型及抗体诊断试剂盒	药物
克拉霉素颗粒	药物
颈性眩晕	疾病
脑脊液蛋白量增高	症状
妊娠时伴有腹痛的阴道流血	症状
联合国国际麻醉品管制	NoneType
注射用科博肽	药物
骨膜反应	NoneType
宁心益智口服液	药物
珍珠层粉	药物
琥珀多寐丸	药物
老年人间质性肺炎	疾病
盐酸洛美沙星胶囊	药物
氨苄西林干混悬剂	药物
甲磺酸加替沙星分散片	药物
癫痫散	药物
肩袖损伤	疾病
继发性女阴过度角化	疾病
风湿福音丸	药物
丹王颗粒	药物
地西泮	药物
藻酸双酯钠注射液	药物
肾脾双补口服液	药物
顽痹	疾病
急性放射性甲状腺炎	疾病
阿昔洛韦葡萄糖注射液	药物
感冒止咳冲剂	药物
小儿化痰止咳冲剂	药物
酮洛芬肠溶胶囊	药物
抗感冒颗粒	药物
伤乐气雾剂	药物
阴道壁息肉	疾病
蚕茧眼药	药物
如意定喘丸	药物
伐普肽	药物
弓状指	症状
食物变应性和不耐受性	疾病
阿托伐他汀钙片	药物
口腔单纯疱疹	疾病
小儿莫拉雷脑膜炎	疾病
益多酯片	药物
双歧杆菌	NoneType
补脾益肠丸	药物
慢性淋巴结炎	疾病
溴必利	药物
血小板计数	检查科目
盐酸黄酮哌酯胶囊	药物
马尾损伤	症状
抗肾小球基底膜抗体	检查科目
化学性眼外伤	疾病
空腹时腹部有振水声者	症状
顽固性头痛	症状
妇炎康复胶囊	药物
防风通圣颗粒	药物
腐生葡萄球菌	细菌
肉痉	疾病
血液丙酮酸	NoneType
奥扎格雷	药物
甘露聚糖肽胶囊	药物
安替可胶囊	药物
系统性红斑狼疮所致脊髓病	疾病
玉泉丸	药物
宫颈粘液少	症状
盐酸甲基麻黄碱	药物
乳酸钠注射液	药物
髓鞘化延迟	症状
荧光素钠	药物
四十二味疏肝胶囊	药物
先天性髋关节脱位	疾病
抗乙肝免疫核糖核酸	NoneType
复方丹参	药物
鞣酸小檗碱膜	NoneType
小儿变形性肌张力障碍	疾病
粒细胞集落刺激因子酶联免疫测定试剂盒	药物
毛细血管扩张性共济失调综合征	疾病
注射用天麻素	药物
黄体酮节育器	药物
小儿先天性外胚层发育不良综合征	疾病
乐孕宁口服液	药物
肩膀酸疼	症状
披甲树螽	NoneType
咳喘宁胶囊	药物
痧药	药物
替卡西林	药物
参鹿健肺胶囊	药物
结肠宁栓	NoneType
肘关节畸形	症状
血肿形成	症状
幼女性外阴阴道炎	疾病
中央性颌骨癌	疾病
盐酸丁卡因片	药物
盐酸万古霉素	药物
婴儿消食散	药物
复方聚维酮碘搽剂	药物
硝酸硫胺	药物
抗利尿激素(ADH)分泌增多	症状
美扑伪麻干混悬剂	药物
清心丸	药物
依赖症	疾病
小儿再生障碍性贫血	疾病
苯乙肼	药物
苯磺酸氨氯地平	药物
卵巢性闭经	症状
珍母口服液	药物
珍牡肾骨胶囊	药物
痰厥	疾病
耳聋	NoneType
强骨胶囊	药物
餐后发作性腹痛	症状
肥胖前期	症状
顺铂氯化钠注射液	药物
竹沥片	药物
过早丧失咀嚼功能	症状
老年人上腔静脉受压综合征	疾病
复方南板蓝根片	药物
安宫牛黄栓	NoneType
复方乌鸡口服液	药物
桔贝合剂	药物
苯丙氨酯片	药物
伤痛跌打丸	药物
非阵发性交接区性心动过速	疾病
气管支气管异物	疾病
骨密度增加	NoneType
小儿全远端型肾小管酸中毒	疾病
羊水过少	疾病
骨松康合剂	药物
埃索美拉唑	药物
出血时间	NoneType
失钠性昏迷	症状
血浆皮质醇	NoneType
双乙酰氧苯甲基吡啶	药物
妊娠合并类风湿关节炎	疾病
小儿自身免疫性溶血性贫血伴血小板减少综合征	疾病
硫酸庆大霉素缓释片	药物
朝阳丸	药物
安络化纤丸	药物
盐酸米安色林	药物
孤立性直肠溃疡综合征	疾病
甲状腺功能亢进症	疾病
指甲干瘪	症状
意识朦胧状态	症状
非炎性单纯性突眼	NoneType
处女膜无孔	症状
运动神经元病	疾病
成人先天性髋关节脱位	疾病
次硝酸铋片	药物
原发性腹膜癌	疾病
优球蛋白的溶解时间	药物
颅内黑色素瘤	疾病
囊虫丸	药物
虫草清肺胶囊	药物
瑞列绦虫病	疾病
安神胶囊	药物
酒石酸长春瑞滨	NoneType
跟骨骨折	疾病
怪笑	症状
牛磺酸胶囊	药物
妊娠合并尖锐湿疣	疾病
乳房棘球蚴病	疾病
参茸补酒	NoneType
平啄蜾蠃	NoneType
千草脑脉通合剂	药物
血浆胆固醇水平高	NoneType
风湿止痛丸	药物
短芽孢杆菌	NoneType
颌骨隆凸	疾病
硫酸妥布霉素注射液	药物
康儿灵颗粒	药物
盐酸美沙酮口服液	药物
消积健儿颗粒	药物
清火胶囊	药物
盐酸林可霉素片	药物
虹膜色素痣	疾病
丹鳖胶囊	药物
空间生态学	NoneType
化痔灵片	药物
盐酸多柔比星	药物
通痹胶囊	药物
子宫颈扩张	NoneType
马尿酸乌洛托品片	药物
氯氮	药物
稳压胶囊	药物
尿钙增多	症状
丁香假单胞菌	NoneType
乙肝清热解毒冲剂	药物
蛇胆川贝液	药物
尿频	NoneType
鳞状细胞化生	症状
表皮样囊肿	疾病
肝小静脉闭塞症	疾病
肌苷葡萄糖注射液	药物
小儿脐风散	药物
琥珀酰明胶注射液	药物
盐酸肼屈嗪	药物
足舟骨骨折	疾病
尿闭	NoneType
抱龙丸	药物
硫酸沙丁胺醇口腔崩解片	药物
黑锡丹	药物
两性霉素B脂质体	药物
复发性风湿病	疾病
脑肽胶囊	药物
匹多莫德分散片	药物
甲硝唑呋喃唑酮栓	药物
伊维菌素咀嚼片	药物
阿苯达唑干糖浆	药物
舒筋活络丸	药物
马尿酸乌洛托品	药物
肝细胞脂肪性变	症状
奥美拉唑钠肠溶片	药物
小儿金葡菌性烫伤样皮肤综合征	疾病
薄荷尿素贴膏	药物
呼吸浅慢	症状
健忘	症状
抗心磷脂抗体	检查科目
支气管扩张	NoneType
复方罗布麻片	药物
盐酸洛美沙星滴耳液	药物
儿童退热片	药物
绿色盲	症状
和肝利胆糖浆	药物
拇指内收畸形	症状
五灵丸	药物
先天性胃壁肌层缺损	疾病
丁型肝炎抗体	检查科目
咽反射消失	症状
腹壁坏死性筋膜炎	疾病
调经种子丸	药物
降压丸	药物
血乳酸	NoneType
法莫替丁分散片	药物
羟乙基淀粉130/04	NoneType
孕康糖浆	药物
达替米星	药物
滋肾育胎丸	药物
小儿贝诺酯维B1咀嚼片	药物
盐酸屈他维林	药物
得生片	药物
脐带过短或相对过短	症状
莪术油葡萄糖注射液	药物
百咳静糖浆	药物
当归苦参丸	药物
洛索洛芬钠片	药物
易跌倒	症状
氯化铝	药物
妊娠期高血压	症状
贝诺酯分散片	药物
罗非昔布	药物
神经节苷脂沉积病	疾病
姜酚胶丸	药物
散结镇痛胶囊	药物
小儿烧伤	疾病
风团	症状
牛黄蛇胆川贝软胶囊	药物
指(趾)甲缺失	症状
巨大牙骨质瘤	疾病
临江风药	药物
晶状体膨胀所致青光眼	疾病
新生儿Rh血型不合溶血病	疾病
红细胞体积增大	症状
核心抗体（抗HBc）阳性	症状
溃疡	NoneType
多饮	症状
花红片	药物
红皮病	疾病
苏氨酸	NoneType
良性成牙骨质细胞瘤	疾病
肺宁口服液	药物
食管异位组织	疾病
甲氯芬那酸片	药物
重听	症状
颈痛片	药物
无管胃酸分析	NoneType
外阴疖病	疾病
紫前膏	药物
注射用美洛西林钠	药物
无味黄连素片	药物
羊羔补酒	NoneType
慢性阻塞性腮腺炎	疾病
司他夫定散	药物
黄根片	药物
复方氨酚美沙芬片	药物
吉兰-巴雷综合征	疾病
复方氧化锌软膏	药物
鸡鸣丸	药物
吸附百日咳白喉破伤风乙型肝炎联合疫苗	药物
莱阳梨止咳颗粒	药物
罗通定	药物
身体下部短于上部	NoneType
骨产道异常	症状
眼底病	疾病
哮喘胶囊	药物
胼胝	疾病
铅黄肠球菌	NoneType
眼部猪囊尾蚴病	疾病
四联菌苗	药物
解肌宁嗽口服液	药物
急肝退黄胶囊	药物
钩端螺旋体病神经系统表现	疾病
脊髓分裂症	疾病
耳鼓膜破裂	症状
千金止带丸水丸	药物
健身全鹿丸	药物
克泻敏丸	药物
口腔颌面部烧伤	疾病
放射性心包炎	疾病
精乌胶囊	药物
虎力散	药物
肿节风	药物
氨咖麻敏胶囊	药物
环丝氨酸	药物
次水杨酸铋咀嚼片	药物
功能失调性子宫出血病	疾病
喉刺伤	疾病
盐酸林可霉素滴眼液	药物
盐酸美西律胶囊	药物
特发性非硬化性门脉高压综合征	疾病
枸橼酸坦度螺酮	药物
六应丸	药物
阿佐塞米	药物
HZC	NoneType
盐酸格拉司琼胶囊	药物
结核性角膜病变	疾病
六味地黄口服液	药物
呼吸道异物	疾病
溴疹	症状
Goodpasture综合征	疾病
下腹坠胀	症状
反复高热	症状
桂美酸片	药物
正清风痛宁	药物
淋球菌性腹膜炎	疾病
真菌性甲沟炎	疾病
老年人再生障碍性贫血	疾病
吐弄舌	NoneType
非那雄胺胶囊	药物
氟康唑分散片	药物
尿素氮	检查科目
鸡血藤胶囊	药物
枸杞益元酒	NoneType
尼莫地平控释片	药物
甲磺酸托烷司琼注射液	药物
妊娠合并缺铁性贫血	疾病
球孢子菌病	疾病
尿沉渣管型	检查科目
皮下脂膜炎性T细胞淋巴瘤	疾病
阴挺	疾病
尿淀粉酶升高	症状
右旋糖酐20葡萄糖注射液	药物
消炎利胆滴丸	药物
鞘膜积液	NoneType
肝性血卟啉病综合征	疾病
遗传性异常纤维蛋白原血症	疾病
血管壁变薄	症状
复方白头翁胶囊	药物
硝酸异山梨酯注射液	药物
屈肌腱损伤	疾病
雪胆胃肠丸	药物
心尖肥厚型心肌病	疾病
斜颈	疾病
盐酸金霉素软膏	药物
牛黄安心丸	药物
多糖铁胶囊	药物
萘哌地尔	药物
注射用呋脲苄西林钠	药物
混合型肾小管性酸中毒	疾病
匐行疹	疾病
吡哌酸胶囊	药物
自动Babinske征阳性	症状
格列吡嗪分散片	药物
曲匹地尔	药物
五肽胃泌素胃液分析	NoneType
晶状体移位	症状
快速进行性牙周炎	疾病
葡萄糖酸锌胶囊	药物
硬化	症状
髌腱断裂	疾病
暑湿感冒冲剂	药物
灭澳灵片	药物
幻听	症状
脑白质稀疏	症状
参苓白术丸	药物
湿痹	NoneType
独活寄生丸	药物
支原体	NoneType
肥儿片	药物
白带净丸	药物
小儿慢性良性中性粒细胞减少症	疾病
血府逐瘀口服液	药物
紫茶颗粒	药物
注射用磺苄西林钠	药物
感染性心内膜炎	疾病
八味肾气丸	药物
双橘颗粒	药物
跟腱前囊炎	疾病
青蒿油软胶囊	药物
古威活络酊	药物
头孢替安	药物
儿咳糖浆	药物
脑立清片	药物
复方苦木消炎分散片	药物
增殖体肥大	症状
盐酸洛美利嗪胶囊	药物
益脑复健胶囊	药物
淋球菌性结膜炎	疾病
柴胡注射液	药物
盐酸吗啡片	药物
精子数	检查科目
尼索地平缓释片	药物
洛美利嗪	药物
湿毒清胶囊	药物
小儿莱施-尼汉综合征	疾病
血管伤	症状
小儿病毒性心肌炎	疾病
千金茶	药物
木香分气丸	药物
陈夏六君子丸	药物
阿扎司琼	药物
镰孢属	细菌
上列牙痛	症状
盐酸地匹福林滴眼液	药物
乳腺发育不良	症状
假性前房积脓	症状
着色真菌病	疾病
趾端干枯发黑	症状
复方马缨丹片	药物
生理性醉酒	症状
高钾血症	疾病
脑外伤	疾病
脱皮	症状
乙醚中毒	疾病
金黄色葡萄球菌肺炎	疾病
伤寒	疾病
血清乳糖	检查科目
风湿灵片	药物
一过性肉眼血尿	症状
抑肽酶	药物
白花蛇舌草注射液	药物
脐尿管残余	症状
鞣酸加压素	药物
补益活络丸	药物
额区感觉减退	症状
小儿腹泻贴	药物
腔隙性脑梗死	疾病
肺泡蛋白质沉积症	疾病
脾虚	症状
升主动脉根部环状缩窄	症状
小儿库欣综合征	疾病
多发性遗传性骨软骨瘤	疾病
电击伤	NoneType
复方肝水解物片	药物
牛痘样水疱病	疾病
卵巢卵黄囊瘤	疾病
苦参地黄丸	药物
健步虎潜丸	药物
先天性胫骨假关节	疾病
柳氮磺吡啶结肠溶胶囊	药物
参茸多鞭酒	药物
健胃片	药物
放射性烧伤	疾病
心室静止	疾病
副肿瘤性斜视性眼肌阵挛-肌阵挛	疾病
冰黄肤乐软膏	药物
家蚕质型多角体病毒 SZ 株	NoneType
生脉胶囊	药物
腹壁血栓性静脉炎	疾病
交肠	疾病
抗感冒颗粒(低糖型)	药物
氢化可的松片	药物
拉克替醇	药物
荨麻疹型药疹	疾病
宝珍膏	药物
低补体血症	疾病
厌食	症状
清开灵滴丸	药物
磨牙	疾病
纵隔肿瘤	疾病
瑞芬太尼	药物
支气管肺炎	疾病
红管药片	药物
多维元素片29	药物
耳廓变大	症状
尼古丁舌下片	药物
晶状体蛋白逸出	症状
苯丁酸钠	药物
益髓冲剂	药物
香归逍遥颗粒	药物
鼻塞排出脓性或血性分泌物	NoneType
维洛沙秦	药物
小儿细菌性痢疾	疾病
甲状腺功能减低所致贫血	疾病
男性生殖腺机能减退症	疾病
飞龙夺命丸	药物
肛区为皮肤覆盖	症状
腹内压升高	症状
青果片	药物
龙胆泻肝口服液	药物
枸橼酸铋钾胶囊	药物
复方维生素U片	药物
向胸腰段脊髓供血的大根动脉缺血症候群	疾病
马来酸曲美布汀胶囊	药物
正天丸	药物
马来酸氯苯那敏控释胶囊	药物
清喉散	药物
痰中带血丝	症状
胸腺肽肠溶片	药物
银杏叶滴剂	药物
排毒清脂片	药物
青春期发育迟缓	疾病
美索巴莫注射液	药物
三金感冒片	药物
精制抗狂犬病血清	药物
乳癖散结片	药物
白虎合剂	药物
阴囊水肿	症状
花蕊石止血散	药物
度他雄胺	药物
马来酸桂哌齐特	药物
硫酸特布他林片	药物
千金保孕丸	药物
消渴病	疾病
空肠、回肠憩室	疾病
醋氨己酸锌胶囊	药物
七味红花殊胜散	药物
硝普钠	药物
通乳颗粒	药物
蹼状阴茎	疾病
跌打止痛散	药物
被迫体位	症状
真菌性巩膜炎	疾病
昆仙胶囊	药物
曲昔匹特胶囊	药物
先天性视网膜劈裂	疾病
安神宝颗粒	药物
注射用因卡膦酸二钠	药物
原发性骨髓纤维化	疾病
腓总神经损害	NoneType
复方阿托品麻黄碱栓	药物
复方当归注射液	药物
小活络片	药物
醋酸可的松注射液	药物
利他林	药物
玉簪清咽十五味丸	药物
妇科止带片	药物
华佗膏	药物
胆道蛔虫症	疾病
脊髓火器伤	疾病
维生素B1	药物
诺迪康胶囊	药物
帕米磷酸二钠	药物
黄芪建中丸	药物
洛贝林	药物
补中益气合剂	药物
固元胶囊	药物
薯蓣丸	药物
非诺洛芬钙肠溶胶囊	药物
克泻灵片	药物
阿魏化痞膏	药物
下肢中枢性瘫痪	症状
苦参总碱	药物
双环醇	药物
和胃止痛胶囊	药物
日晒防治膏	药物
注射用枸橼酸钠	药物
酚类中毒	疾病
鼻咽清毒颗粒	药物
婴儿性骨皮质增生症	疾病
注射用腺苷钴胺	药物
行为动作幼稚愚蠢	症状
盐酸曲马多泡腾颗粒	药物
紧张性手抖	症状
首乌地黄丸	药物
腰部酸胀及无力	症状
肝水解肽注射液	药物
来曲唑	药物
肝癌	疾病
皮肤紫纹	症状
眼-头反射消失	NoneType
寒冷性脂膜炎	疾病
方达帕林	药物
复方益母草胶囊	药物
中青年脑梗死	疾病
克感利咽口服液	药物
部分凝血活酶活性时间	检查科目
尼扎替丁片	药物
腕背侧或掌侧的脓肿或窦道	症状
珍黄安宫片	药物
考来烯胺散	药物
垂腕	症状
非尼拉敏	药物
呼吸急促	症状
新生儿低血糖症	疾病
骨软骨病	疾病
肿瘤坏死因子	药物
切除术后内疝	疾病
糖尿病皮肤病变	症状
T8淋巴细胞亚群	检查科目
九味羌活颗粒	药物
心房扑动	疾病
麻子仁丸	药物
复方青果颗粒	药物
凸腭	症状
口唇出血	症状
暴发性肝衰竭	疾病
胱氨酸片	药物
补体结合试验	检查科目
小儿肠系膜淋巴结结核	疾病
膝及小腿部有广泛的瘀血斑	症状
包醛氧化淀粉	药物
克霉唑溶液	药物
泊洛沙姆	药物
贝诺酯颗粒剂	药物
猴菇饮口服液	药物
瑞替普酶	药物
莫西沙星	药物
琼玉膏	药物
慢性咳嗽	疾病
桂茸固本丸	药物
下腹局部疼痛	症状
盐酸地尔硫卓缓释胶囊	药物
扩张孔	疾病
格列吡嗪缓释片	药物
环戊噻嗪片	药物
调脂片	药物
维生素B族缺乏	症状
蛔虫性肠梗阻	疾病
谊妄	NoneType
单纯性疱疹	疾病
青霉	细菌
血液硫化血红蛋白	NoneType
热淋清糖浆	药物
江南卷柏片	药物
第三脑室肿瘤	疾病
病毒性脑膜炎	疾病
肩袖间隙分裂	疾病
妇康宝颗粒	药物
保和丸浓缩丸	药物
慢性心功能不全	疾病
盐酸特比萘芬喷剂	药物
UE测试	NoneType
吗多明片	药物
康妇凝胶	药物
注射用阿莫西林克拉维酸钾	药物
唇干舌燥	症状
环磷腺苷葡萄糖注射液	药物
气不摄血	症状
大肠埃希杆菌肺炎	疾病
板蓝根片	药物
花柳病	疾病
胚胎停止发育	NoneType
阴道黏膜膨胀	症状
缺血性肠绞痛	疾病
眼眶炎性假瘤	疾病
月见草油胶丸	药物
会阴裂伤	疾病
子宫硬如板状	症状
胃液总量	NoneType
尼莫唑	药物
无法数清每分钟脉搏次数	症状
栀子金花丸	药物
小儿亚急性骨髓炎	疾病
复方布洛芬片	药物
血清病和血清病样反应	疾病
侧孢芽孢杆菌	NoneType
内科医生	NoneType
复合凝乳酶胶囊	药物
进行性消瘦	症状
肝苏软胶囊	药物
联苯乙酸	药物
琥珀氯霉素	药物
小儿轮状病毒性肠炎	疾病
牛黄醒脑丸	药物
草乌甲素	药物
鼓室硬化症	疾病
罗格列酮	药物
风湿性多肌痛	疾病
思维解体	症状
复方酸藤消痔胶囊	药物
卡他莫拉菌感染	疾病
第Ⅰ型脊髓血管畸形	疾病
鼠疫样皮损	症状
窦房折返性心动过速	NoneType
兰索拉唑片	药物
津力达颗粒	药物
红古豆碱	药物
淋巴细胞转化率	NoneType
甲基橙皮苷	药物
香砂养胃丸(浓缩丸)	药物
间苯二酚溶液	药物
锁阳补肾胶囊	药物
阴吹	疾病
猴枣牛黄散	药物
云南白药痔疮膏	药物
脑脊液丙氨酸氨基转移酶	症状
塞隆骨	NoneType
脖子扭痛	症状
背部出现小水泡	症状
虫草被孢菌粉	NoneType
薄荷麝香草脑搽剂	药物
盔盖小菇	NoneType
小儿至宝丸	药物
硬脊膜外脓肿	疾病
通脉养心口服液	药物
乙型肝炎e抗体	检查科目
婴儿厌食	NoneType
尿氯	检查科目
复方五味子糖浆	药物
复方决明片	药物
阿莫西林双氯西林钠片	药物
强筋英雄丸	药物
瞳孔固定	症状
先天性尺桡骨性连接	疾病
小儿肾小管-间质肾炎	疾病
注射用血栓通冻干	药物
阴道美丽筒线虫病	疾病
肠病原性大肠埃希杆菌感染	疾病
抗骨增生口服液	药物
德氏乳杆菌	NoneType
不动纤毛综合征	疾病
间歇性外斜视	疾病
水杨酸甲酯	药物
弥漫性脂肪变性	症状
貂胰防裂膏	药物
精乌片	药物
老年人正常压力脑积水	疾病
脸颊出现红血丝	症状
荚膜组织胞浆菌病	疾病
胼胝体发育不良	症状
躁狂抑郁症	疾病
新生儿低血磷	症状
胸壁皮下气肿	疾病
氰化高铁Hb测定法	检查科目
老年人胆石症	疾病
盐酸甲麻黄碱片	药物
掌指关节脱位	疾病
泌尿生殖系真菌病	疾病
石榴健胃胶囊	药物
余麦口咽合剂	药物
额部疼痛	症状
丁二酸洛沙平	药物
下消丸	药物
氨苯蝶啶	NoneType
肝火上炎证	疾病
脉搏脱漏	症状
益多酯胶囊	药物
精神依赖性	症状
金嗓清音丸	药物
二乙基二硫代氨基甲酸钠	药物
卵巢囊肿蒂扭转	疾病
小儿肾性贫血	疾病
二丁冲剂	药物
甲氧氯普胺	药物
原发性肺动脉高压	疾病
真菌性皮肤病	疾病
文冠果子仁霜	NoneType
附片液	NoneType
甘桔冰梅片	药物
阴道持续中量流血	症状
乳酸环丙沙星氯化钠注射液	药物
乳酸乳球菌乳脂亚种	NoneType
阴茎痰核	疾病
复方川芎胶囊	药物
六神祛暑水	NoneType
合成鱼腥草素	药物
溃疡坏死性口炎	疾病
牙齿呈棕黑色	症状
小儿炎症性肠病	疾病
复方蓝棕果片	药物
小儿泄泻	NoneType
五氯酚钠中毒	疾病
紫丹银屑胶囊	药物
子宫收缩乏力	疾病
儿童顿咳	疾病
梭形细胞脂肪瘤	疾病
胸椎腰化	症状
注射用盐酸万古霉素	药物
重复尿道	疾病
颈椎半脱位	疾病
注射用盐酸博安霉素	药物
散寒解热口服液	药物
盐酸普罗帕酮片	药物
嗜水气单胞菌感染	疾病
调经益灵片	药物
静灵口服液	药物
胀痛	症状
乐卡地平	药物
橙皮糖浆	药物
小儿抽风散	药物
小儿惊厥	疾病
桑麻口服液	药物
舌齿龈疼痛性粟粒至水疱	症状
婴儿褐色或暗绿色的粘液便	症状
手外伤	疾病
轻粉	药物
小儿脑挫裂伤	疾病
老年性阴道炎	疾病
增效联磺片	药物
尼鲁地平	药物
功能性下丘脑性闭经	疾病
视神经乳头苍白	症状
脉络宁颗粒	药物
频繁遗精	症状
神经元肿瘤和神经元与神经胶质混合性肿瘤	疾病
声门以上的损伤	症状
血浆蛋白检测试剂铁蛋白抗血清	NoneType
阿胶补血颗粒	药物
感速康片	药物
腺病毒性肠炎	疾病
清热利胆冲剂	药物
风寒感冒	疾病
尼鲁米特	药物
马来酸左旋氨氯地平片	药物
螺内酯胶囊	药物
宽胸利膈丸	药物
体内水钠潴留	症状
心脏脂肪瘤	疾病
小脑扁桃体疝	疾病
回归热型结节性非化脓性脂膜炎	疾病
牛至肝康丸	药物
泛酸钙片	药物
前臂旋转痛	症状
口炎清含片	药物
氯唑沙宗片	药物
导便栓	NoneType
非梭状芽胞杆菌肌坏死	疾病
眼眶血肿	疾病
疲劳	症状
健心片	药物
西黄丸	药物
氨酚曲马多片	药物
消伤痛搽剂	药物
肝胆清胶囊	药物
血浆蛋白检测试剂补体成份C3抗血清	NoneType
脾肾两助丸	药物
唇上长有小水泡	症状
完全性房室传导阻滞	疾病
外阴湿疹	疾病
丁二酸洛沙平胶囊	药物
散痛舒片	药物
珍珠生肌散	药物
肾炎片	药物
瘀斑	症状
先天性大疱性鱼鳞病样红皮病	疾病
心室间隔缺损	症状
感觉分离	症状
乳酸钙	NoneType
两侧颊部及颞部凹入	症状
小儿过敏性紫瘢	NoneType
紫冰油	NoneType
肝功检查胆红素及转氨酶常增高	症状
越鞠保和丸	药物
复方枇杷喷托维林颗粒	药物
心率不齐	症状
肛门闭锁	疾病
氯丙嗪异丙嗪注射液	药物
疤痕	疾病
溃疡病急性穿孔	疾病
乳酸钠溶液	药物
妇科止带胶囊	药物
尿亮氨酸氨基肽酶	NoneType
玻璃体有血迹	症状
异源内分泌综合征	疾病
痛性阴茎勃起	症状
妇必舒胶囊	药物
老年人支气管哮喘	疾病
右旋糖酐70滴眼液	药物
贝诺酯胶囊	药物
老年人甲状腺癌	疾病
飞扬喉	疾病
乙基吗啡	药物
注射用抗乙肝转移因子	药物
康肾颗粒	药物
甲磺酸酚妥拉明胶囊	药物
浅部急性淋巴结炎和淋巴管炎	疾病
不宁腿综合征	症状
养血愈风酒	药物
硫酸四氢帕马丁注射液	药物
解肌宁嗽片	药物
表情迟钝	症状
乳房疼痛	NoneType
风湿镇痛丸	药物
慢性创伤性滑囊炎	疾病
慢性膀胱炎	疾病
新生化冲剂	药物
全面性发作	症状
甲溴阿托品片	药物
葡萄糖试剂盒	药物
辛酸纳	药物
玫瑰疹	症状
雷凡斯坦综合征	疾病
镍皮炎	疾病
小儿霍奇金病	疾病
白色黏液状尿	症状
儿童反复骨折	症状
益诺胶囊	药物
循环免疫复合物	NoneType
盐酸丁卡因	药物
肾小管葡萄糖最大重吸收量试验	检查科目
贝美格	药物
纵隔病变	症状
心源性胸痛	症状
尿清舒颗粒	药物
复方氯己定达克罗宁乳膏	药物
九味渣驯丸	药物
血浆蛋白检测试剂纤维蛋白溶血酶原(Pg)抗血清	NoneType
门多萨假单胞菌	细菌
阴离子间隙	检查科目
藏青果冲剂	药物
枣仁安神胶囊	药物
甘露酥油丸	药物
半夏止咳颗粒	药物
盆腔脓肿	NoneType
胎儿生长受限	疾病
手指撞伤	症状
产后伤食	疾病
健脾降脂颗粒	药物
少林跌打止痛膏	药物
平溃散	药物
照山白浸膏片	药物
胸腰椎损伤	症状
急性宫颈炎	疾病
小儿先天性肌强直综合征	疾病
肛肠外科	医学专科
双氯芬酸钾凝胶	药物
消癌平胶囊	药物
皮肤呈浅黄或深金黄色	症状
止血纤维贴	NoneType
白色恶露	NoneType
大山楂片	药物
小儿睾丸扭转	疾病
乙酰乌头碱	药物
五子降脂胶囊	药物
小儿脑震荡	疾病
复方鱼腥草合剂	药物
唾液钠	检查科目
甘氨酸	NoneType
艾滋病人的急性阑尾炎	疾病
自身免疫性甲状腺疾病相关肾病	疾病
髋关节前脱位	疾病
学习技能发育障碍	疾病
甘草酸二铵	药物
糖耐量降低	症状
枳实导滞丸	药物
阴道出血	症状
葛根素葡萄糖注射液	药物
产后血气痛	症状
老年人胃癌	疾病
新生儿惊厥	疾病
小儿球形细胞脑白质营养不良	疾病
香云肝泰片	药物
口服五维葡萄糖	药物
妇炎平泡腾片	药物
盐酚芬氟拉明片	药物
马洛替酯缓释片	药物
致康胶囊	药物
重酒石酸去甲肾上腺素	NoneType
萘非滴眼液	药物
脸色发黑	症状
咽颊部烧伤	症状
埃博拉病毒病	疾病
盐酸曲普利啶	药物
小儿选择性免疫球蛋白A缺乏症	药物
食管血管瘤	疾病
安普那韦	药物
甲硝唑口含片	药物
泌尿道阻塞	症状
环苯扎林	药物
追风壮骨膏	药物
小儿解表颗粒	药物
醉酒	症状
麻桂感冒丸	药物
盐酸林可霉素栓	药物
止血散	药物
对听、视、触觉等刺激反应过度	NoneType
注射用硝卡芥	药物
胃乐宁片	药物
婴幼儿胃食管反流	疾病
眼睑皮肤弛缓症	疾病
通脉颗粒	药物
调经养颜胶囊	药物
指甲可见横沟纺	症状
健肝片	药物
蒿甲醚片	药物
氯化钾注射液	药物
下巴长痘	症状
眼睑痉挛-口下颏部肌张力障碍	疾病
颅面裂隙畸形	疾病
水陆二味丸	药物
肺血增多	症状
卡波姆	药物
菌白敏片	药物
伏格列波糖	药物
老年人预激综合征	疾病
上颈髓区病变	症状
痘疮	症状
睑结膜泪阜区灰黑色肿物	症状
肢体运动不协调	症状
头孢噻利	药物
血必净注射液	药物
清眩丸	药物
利尔眠胶囊	药物
肠胃舒胶囊	药物
脊髓灰质炎病毒抗体	检查科目
小儿进行性骨化性肌炎	疾病
中骨盆狭窄	NoneType
胃热清胶囊	药物
巴西固氮螺菌	NoneType
桂枝茯苓片	药物
急性病容	症状
岩鹿乳康胶囊	药物
乳酸诺氟沙星注射液	药物
血吸虫斑点酶联免疫吸附试验	检查科目
维生素E皇浆口服液	药物
食管炎	疾病
消炎利胆胶囊	药物
沼泽红假单胞菌	NoneType
头孢氨苄泡腾片	药物
乳酸左氧氟沙星葡萄糖注射液	药物
肺动脉瓣关闭不全	疾病
桑菊感冒合剂	药物
肾内科	医学专科
吗多明气雾剂	药物
鼻前庭炎	疾病
卡络磺钠片	药物
眼球斑点	症状
先天性mu内翻	疾病
草香胃康胶囊	药物
应激功能减退	症状
护理	药物
多烯磷脂酰胆碱	药物
地奥心血康	NoneType
咯奈啶	药物
二乙酰氨乙酸乙二胺注射液	药物
益肝膏	药物
呋喃妥因片	药物
铁锈色痰	症状
萘甲唑林	药物
羟脯氨酸	检查科目
坤顺丸	药物
阴茎短	症状
西咪替丁胶囊	药物
妊娠性黄褐斑	症状
红霉素肠溶微丸胶囊	药物
胃乃安胶囊	药物
男子乳房发育症	疾病
甲肝减毒活疫苗	NoneType
大动脉炎	疾病
增殖型天疱疮	NoneType
鞣酸小檗碱片	药物
先天性环状束带	疾病
烂耳散	药物
穿心莲片	药物
始于眼部，扩张开来的面头痛	NoneType
吲哚美辛胶囊	药物
坏疽性口炎	疾病
参桂鹿茸丸	药物
双嘧达莫氯化钠注射液	药物
八味西红花清肝热胶囊	药物
扁桃体上有灰色膜	NoneType
黑蒙	症状
大黄流浸膏	药物
隐翅虫皮炎	疾病
桡骨茎突骨折	疾病
次氯酸钠	药物
结核性腹膜炎	疾病
姜黄清脂片	药物
精子形态	检查科目
鼻粘膜苍白水肿	症状
肝炎	疾病
猴耳环消炎胶囊	药物
盐酸妥洛特罗	药物
咳出带臭味的干痂	症状
阿奇霉素肠溶片	药物
人巨细胞病毒	病毒
念珠状发	疾病
虚寒泄泻	疾病
神经纤维肉瘤	疾病
肾动脉狭窄	疾病
岩黄连注射液	药物
天门冬氨酸洛美沙星注射液	药物
黏膜出现出血点	症状
治伤跌打丸	药物
注射用维生素B6	药物
空气栓塞	疾病
单角或双角子宫	症状
右心室流出道	症状
梅毒肝	症状
烧伤创面淡黄色粘稠分泌物	症状
食管贲门粘膜撕裂综合征	疾病
乳糜腹	疾病
舒咽清喷雾剂	药物
尿黄似浓茶	药物
英卡膦酸二钠	药物
茶愈胶囊	药物
托瑞米芬	药物
碱性胚胎蛋白	检查科目
醋酸泼尼松片	药物
妇血安片	药物
羚翘解毒丸浓缩丸	药物
依托度酸片	药物
氟奋乃静	药物
甲状旁腺骨营养不良	疾病
泌尿生殖系血吸虫病	疾病
通脉灵片	药物
维生素C钙胶囊	药物
唇角脱屑	症状
猫喘音	症状
阿洛司琼	药物
憩室病	疾病
胃复宁胶囊	药物
利斯特菌脑膜炎	疾病
金酸萍糖浆	药物
胰腺脑病综合征	疾病
尤瑞克林	NoneType
红花注射液	药物
五味金色丸	药物
眼睛刺痛	症状
单侧面部萎缩	症状
硬柄香菇	NoneType
胸、腰椎爆裂骨折	疾病
妇产科静脉血栓病	疾病
持久性豆状角化过度病	疾病
丹参	NoneType
巨乳头性结膜炎	疾病
硫糖铝颗粒	药物
猪十二指肠提取物	药物
泡状枝动菌	NoneType
酮康唑胶囊	药物
高丽清心丸	药物
阑尾炎	疾病
肌腱拉伤	症状
保安万灵丹	药物
脚臭	症状
玻璃体寄生虫病	疾病
氯波必利片	药物
虹膜炎	疾病
腰背痛	症状
Kaposis肉瘤	疾病
荨麻疹和血管性水肿	疾病
后壁穿孔性溃疡	疾病
阿奇霉素枸橼酸二氢钠	药物
美他多辛	药物
珍石烧伤膏	药物
益康唑	药物
血小板减少性紫癜	疾病
乳头肌断裂	NoneType
小儿腹股沟斜疝	疾病
老年人急性感染后肾炎	疾病
长双歧杆菌	NoneType
去乙酰毛花苷	药物
毛胚细胞瘤	疾病
乙酰胺吡咯烷酮胶囊	药物
肝肾康糖浆	药物
光辉霉素	药物
异位胰腺	疾病
小儿尿色发蓝	症状
乳痈	疾病
咽喉痛	NoneType
杜仲颗粒	药物
盐酸罂粟碱片	药物
非诺贝特分散片	药物
氯酚黄敏片	药物
烟胺羟丙茶碱	NoneType
腰膝酸软	NoneType
地拉普利	药物
胸腔积液	疾病
磺胺对甲氧嘧啶片	药物
骨疏康颗粒	药物
吗氯贝胺	药物
脊髓后动脉缺血症候群	疾病
小儿腿抽筋	症状
新生儿抽搐	症状
糖链抗原724	检查科目
颈根部斜方肌及风池穴处有压痛点	症状
口腔炎喷雾剂	药物
金槐冠心片	药物
昔萘沙美特罗气雾剂	药物
琥珀酸洛沙平	药物
参丹散结胶囊	药物
弯曲芽胞杆菌	NoneType
颅底肿瘤	疾病
健步丸	药物
偏盲偏身感觉障碍	症状
阿氏芽孢杆菌	NoneType
庆大霉素硝酸铋胶囊	药物
奥美拉唑钠	药物
清热化湿口服液	药物
尼可占替诺	药物
苯噻啶	药物
神经梅毒	疾病
先天性桡骨缺如	疾病
益母草膏	药物
贝卡普勒明	药物
氨苄青霉素钠栓	药物
小儿盘肠气痛	疾病
金刚藤胶囊	药物
判断力和定向力障碍	症状
汗孔角化病	疾病
难治性腹水	症状
食管破裂	疾病
矮小症	疾病
圣济鳖甲丸	药物
煤尘或胆固醇结晶的黏痰	症状
散寒活络丸	药物
夏桑菊颗粒	药物
白蛋白放免药盒	药物
小儿先天性侏儒痴呆综合征	疾病
髂窝部疼痛	症状
乙型肝炎核心抗体免疫球蛋白G	药物
进食过硬的食物口腔损伤	症状
洛哌丁胺	药物
婴儿痉挛症	疾病
肥大细胞白血病	疾病
《本事方续集》	NoneType
琥珀消石颗粒	药物
小腿下部色素沉着、脱屑、湿疹	NoneType
三七丹参片	药物
复方平贝口服液	药物
小三阳	症状
涩肠止泻散	药物
喉结核	疾病
氟哌啶醇注射液	药物
小儿转移性骨肿瘤	疾病
鼻炎宁颗粒	药物
复肝宁片	药物
止嗽丸	药物
卵巢浆液性肿瘤	疾病
鹤草酚	药物
氧化樟脑	药物
直肠膨出	疾病
老年男性性功能障碍	疾病
格列齐特缓释片	药物
孕妇小腿浮肿	症状
五羚丹胶囊	药物
一度房室传导阻滞	疾病
电击样剧痛	症状
珍黄片	药物
胃蛋白酶口服溶液	药物
呱西替柳片	药物
血压平片	药物
铝镁颠茄片	药物
脑血康颗粒	药物
生血康口服液	药物
伏格列波糖胶囊	药物
那如三味片	药物
神经症	疾病
盐酸阿米洛利片	药物
阿雷地平	药物
妊娠性心肌梗死	疾病
进食样自动症	疾病
入睡障碍性失眠	症状
哌泊塞嗪	药物
胎盘部分残留	NoneType
眼结膜黑变	症状
房事头疼症	疾病
连蒲双清胶囊	药物
三味檀香胶囊	药物
抗体依赖性细胞(K细胞)毒性	检查科目
小儿健脾口服液	药物
复方二氯醋酸二异丙胺片	药物
吗替麦考酚酯	药物
多囊卵巢	症状
癫痫和癫痫样发作	症状
复方儿茶胶囊	药物
小儿无甲状腺性克汀病	疾病
心理麻木	症状
扁桃体炎	疾病
指甲倒刺	NoneType
苯磺酸左旋氨氯地平	药物
颈强直	症状
乳酸司帕沙星	药物
唾液淀粉酶	检查科目
五味清浊散	药物
小脑功能损害	症状
小儿汞中毒	疾病
眼睑疖肿和脓肿	疾病
消淋败毒丸	药物
盐酸美他环素	药物
氯咖黄敏片	药物
犬瘟热病毒	NoneType
盐酸多西环素胶丸	药物
清解颗粒	药物
复方氯丙那林溴已新片	药物
小儿家族性低血磷性佝偻病	疾病
静脉曲张综合征	疾病
慢性边缘性龈炎	疾病
琥乙红霉素	药物
颈部可前屈，怕仰伸	症状
洋参保肺丸	药物
不孕症	疾病
细菌性前列腺炎	疾病
肾上腺色腙片	药物
胰腺囊性纤维性变	疾病
粉红色泡沫痰	症状
硬脑膜外脓肿	疾病
无睾丸	药物
螨皮炎	疾病
酒渣鼻样结核疹	疾病
咳喘宁	药物
加味逍遥口服液	药物
腓肠肌痉挛性疼痛	症状
清感穿心莲片	药物
复方氯化钠滴眼液	药物
肝速康胶囊	药物
生脉糖浆	药物
头孢尼西钠	药物
鼻翼厚	症状
脏寒	疾病
腰椎病	疾病
热咳	疾病
尿道损伤	疾病
乳酸脱氢酶同工酶	NoneType
注射用盐酸瑞芬太尼	药物
抗乙型肝炎胎盘转移因子注射液	药物
琥珀抱龙丸	药物
新霉素氟轻松软膏	药物
双氯芬酸二乙胺	药物
复方氢溴酸右美沙芬胶囊	药物
宫颈白斑	疾病
实体肿瘤的肾脏损害	疾病
肾炎舒颗粒	药物
地奥司明	药物
多发脑梗死性痴呆	疾病
外用重组人表皮生长因子衍生物	NoneType
产妇安胶囊	药物
新生儿低钙血症	疾病
抗胃壁细胞抗体	检查科目
垂体后叶粉	药物
间歇性眼球突出症	疾病
下消化道少量出血	症状
尿羟脯氨酸	NoneType
胆木注射液	药物
氟诺洛芬	药物
枸橼酸钾颗粒	药物
骨盆损伤	症状
复方羊角片	药物
原发性肝内硬化综合征	疾病
长春西汀注射液	药物
第5指短小弯曲	症状
黄单胞菌	NoneType
鼻乳头状瘤	疾病
二甲硅油气雾剂	药物
血清丙酮酸激酶	NoneType
体肺循环栓塞	症状
头孢唑林钠	药物
一捻金	药物
补肾康乐胶囊	药物
海他西林	药物
甲氯芬那酸	药物
皮肤科	医学专科
橘半止咳颗粒	药物
手掌呈黑色	症状
霍乱样综合征	疾病
红细胞生成素	检查科目
康嫒颗粒	药物
口角生疮	NoneType
参芪降糖胶囊	药物
盐酸左布诺洛尔滴眼液	药物
筋瘤	疾病
先天性拇内翻	疾病
人类免疫缺陷病毒抗体12型/P24抗原1型诊断试剂盒酶联免疫法	药物
耻骨上痛	症状
左卡尼汀口服液	药物
呋喃嘧酮	药物
脑脊液囊虫病间接血球凝集试验	检查科目
尼美舒利片	药物
内脏性肥胖	症状
脑蛋白水解物片	药物
龋	疾病
注射用盐酸拓扑替康	药物
手指麻痛	症状
羚翘解毒丸(浓缩丸)	NoneType
肝炎后综合征	疾病
皮肤念珠菌病	疾病
胃肠感冒	症状
黄酮哌酯	药物
脑塞通丸	药物
苯唑西林	药物
婴幼儿脐疝	疾病
复方氨茶碱片	药物
口腔颌面部肿瘤	疾病
胆道癌	疾病
臀肌萎缩	症状
注射用牛肺表面活性剂	药物
川楝素	药物
多糖蛋白片	药物
复方丹参片	药物
复方胰酶散	药物
盐酸哌仑西平	药物
多维元素片(25)	NoneType
进食流泪	NoneType
蛋氨酸吸收不良综合征	疾病
口唇渗液	症状
疣状癌	疾病
薄芝菌注射液	药物
维生素E软胶囊	药物
眉弓疼痛	症状
非玻璃体的病变眼前飞蚊	NoneType
外用无敌膏	药物
吗替麦考酚酯片	药物
盐酸奥昔非君	药物
鼻中隔偏曲	疾病
小肠过敏性紫癜	NoneType
Happy99	NoneType
左卡尼汀	药物
双黄连合剂	药物
泮托拉唑钠	药物
抗感染能力下降	症状
牛带绦虫病	疾病
咽部麻风	疾病
牛黄噙化丸	药物
尿比重3h试验	检查科目
粘膜乳突状生长	症状
全鸡拔毒膏	药物
盐酸曲马多缓释片	药物
抗A抗B血型定型试剂	药物
胆肠内引流术后内疝	疾病
滑脉	症状
胆囊触痛征	症状
并指（趾）畸形	NoneType
产脲节杆菌	NoneType
附桂骨痛片	药物
环跳疽	疾病
静脉注射用人免疫球蛋白(PH4)	药物
前列通瘀胶囊	药物
右旋酮洛芬氨丁三醇	药物
风油精	药物
小儿化毒散	药物
壮腰健肾口服液	药物
复方醋酸氟轻松酊	药物
男性乳房大	症状
绞股蓝总甙胶囊	药物
注射用硫酸妥布霉素	药物
坤宁颗粒	药物
胆道出血	疾病
枸橼酸铝	药物
大小便失禁	症状
甲氧西林	药物
知柏地黄颗粒	药物
桂枝茯苓丸	药物
智能减退	症状
黄芪精	药物
乳糖酸阿奇霉素注射液	药物
腰痛宁胶囊	药物
老年人巨幼细胞性贫血	疾病
格列本脲胶囊	药物
白内障	疾病
组织液渗出	症状
巴美生	药物
氯喹那多普罗雌烯阴道片	药物
妊娠合并急性肾盂肾炎	疾病
复方芩兰口服液	药物
胃活灵片	药物
复方手参益智胶囊	药物
酒渣鼻	疾病
小儿抽动秽语综合征	疾病
康艾扶正胶囊	药物
四君子袋泡剂	药物
荡石片	药物
血清甲状腺素结合前白蛋白	检查科目
三鞭酒	NoneType
龟黄补酒	NoneType
头孢硫脒	药物
湿阻	NoneType
苦参片	药物
Whitfield硬红斑	疾病
参桂养荣丸	药物
盐酸吗啉胍片	药物
肝肾安糖浆	药物
清热消炎宁	药物
复方阿司匹林	药物
心舒宝胶囊	药物
伤筋正骨酊	药物
海龙胶颗粒	药物
利胆排石片	药物
韦格纳肉芽肿	疾病
梭状芽胞杆菌伤口感染	疾病
喉粘液囊肿	疾病
重舌	疾病
盐酸罂粟碱	药物
鼻骨骨折	疾病
口服补液盐II	NoneType
屈曲指	症状
复方碘苷眼膏	药物
清瘟消肿九味丸	药物
更年期角化症	疾病
青年性驼背	疾病
维生素D2	药物
婴宁散	药物
睑结膜出现灰白色膜	症状
支原体感染	疾病
寒湿痹颗粒	药物
焦虑	症状
滋补酥油丸	药物
支气管结核	疾病
甲亢合并妊娠	疾病
比哌立登	药物
阿托伐醌	药物
复方川贝精片	药物
尿谷氨酰胺	药物
吗茚酮	药物
益肾壮阳膏	药物
舒肺糖浆	药物
上矢状窦血栓性静脉炎	疾病
氟哌利多注射液	药物
中耳炎	疾病
至灵胶囊	药物
消渴平片	药物
言语增多	症状
额叶癫痫的眶额区发作	症状
清脑降压胶囊	药物
银翘解毒冲剂	药物
牛黄镇惊丸	药物
维司力农	药物
妇乐颗粒	药物
冰石愈伤软膏	药物
乙酰水杨酸孕烯诺龙片	药物
筋骨疼痛酒	药物
肝被膜紧张	症状
房内传导阻滞	症状
灵芝菌合剂	药物
右旋酮洛芬氨丁三醇胶囊	药物
成釉细胞瘤	疾病
复方乌梅祛暑颗粒	药物
肺炎支原体寒冷凝集试验	检查科目
富马酸溴长春胺	药物
鼻子发黑	症状
急性胆源性胰腺炎	疾病
骨增消片	药物
双藤筋骨片	药物
精子子宫黏液贯通试验	检查科目
小青龙口服液	药物
益肝灵软胶囊	药物
柳胺酚片	药物
妇乐片	药物
罗他霉素	药物
西瓜霜润喉片	药物
氢溴酸依他佐辛注射液	药物
降糖丸	药物
遗传性多发脑梗死性痴呆	疾病
女金胶囊	药物
酮洛芬胶囊	药物
先天性膝关节脱位	疾病
十二指肠高度扩张	症状
小儿非霍奇金淋巴瘤	疾病
复方谷氨酰胺颗粒剂	药物
莫匹罗星	药物
口唇发黄	症状
多瓣膜病	疾病
林可霉素维B6软膏	药物
活血壮筋丹	NoneType
肝复乐胶囊	药物
舒脑欣滴丸	药物
噻氯匹定	药物
麝香抗栓丸	药物
培高利特	药物
下腹部反跳痛	症状
持续性交接区折返性心动过速	疾病
心包压塞	症状
红细胞沉降率	NoneType
水杨酸苯酚软膏	药物
皮肤卟啉病	疾病
外阴黑色素瘤	疾病
苁蓉通便口服液	药物
慢性萎缩性肢皮炎	疾病
益脉康分散片	药物
镍中毒	疾病
小儿急性喉炎	疾病
注意障碍	症状
全血铬	检查科目
睡觉时突然抽搐一下	症状
淤滞性皮下硬化症	疾病
烧伤喷雾剂	药物
膝盖扭伤	症状
肱骨外髁骨折	疾病
新生儿迁延性胆汁淤积性黄疸	疾病
血清睾酮浓度明显升高	症状
枸橼酸氯米芬	NoneType
老年静脉血栓症	疾病
颈部潮红	症状
组织细胞纤维瘤	疾病
疮疡膏	药物
橄榄晶冲剂	药物
皮肤猪囊尾蚴病	疾病
阿西美辛胶囊	药物
喉痛丸	药物
吸入用七氟烷	药物
自杀行为	症状
皮肤干燥呈腊黄色	症状
癣药玉红膏	药物
性障碍	疾病
肺毛霉病	疾病
下肢的感觉，肌力，神经异常	NoneType
克痤隐酮霜	药物
氯霉素滴眼液	药物
盐酸吗啉双胍	药物
天柱倒	疾病
心肌缺氧	症状
老年人主动脉瘤	疾病
心痛舒喷雾剂	药物
出血性休克和脑病综合征	疾病
急性浅表性包皮龟头炎	疾病
经期缩短	症状
头孢克洛缓释片	药物
眼氨肽注射液	药物
尿环磷酸腺苷	NoneType
雷替曲塞	药物
十五味黑药胶囊	药物
结直肠损伤	疾病
五味甘露药浴洗剂	药物
乳酸依沙吖啶溶液	药物
长春新碱	药物
注射用盐酸拉贝洛尔	药物
晕眩	症状
小儿雅司病	疾病
脓包型痘痘	NoneType
光过敏	症状
腺体结节	症状
烧伤创面粪臭味分泌物	症状
胫骨疼痛	症状
二甲硅油片	药物
上肢周围性瘫痪	症状
指甲中央部分隆起	NoneType
骨癌	疾病
老年人肾癌	疾病
保胎丸	药物
埃及血吸虫病	疾病
克雷白杆菌属感染	疾病
清感九味丸	药物
胃立康片	药物
杏灵分散片	药物
硫酸庆大霉素滴眼液	药物
维血康糖浆	药物
十一酸睾酮	药物
硝酸舍他康唑	药物
杯状耳	NoneType
复方鳖甲软肝片	药物
抗骨骼肌抗体	检查科目
豆腐果苷	药物
四肢长骨和肌肉无规律的酸痛	症状
呋喃妥因肠溶胶囊	药物
柳胺酚胶囊	药物
香砂养胃胶囊	药物
清火片	药物
疟疾间接免疫荧光试验	检查科目
乳酸钠林格注射液	药物
奥替溴铵片	药物
碘番酸	药物
氨苯甲酸	药物
氧氟沙星葡萄糖注射液	药物
盐酸丁丙诺啡舌下片	药物
月经发黑	症状
六和茶	药物
珍珠明目液	NoneType
琥珀化痰镇惊丸	药物
黑色棘皮症	疾病
枸橼酸莫沙必利片	药物
毒瘾	疾病
红药气雾剂	药物
鲑降钙素注射液	药物
卡屈嗪	药物
强迫性联想	症状
疏血通注射液	药物
六神曲	药物
樟脑薄荷柳酯乳膏	药物
垂体腺瘤	疾病
炉甘石洗剂	药物
戊四硝酯片	药物
滋补水鸭合剂	药物
十枣丸	药物
注射用水溶性维生素	药物
尿瘘	疾病
指甲呈筒形	症状
乙型病毒性肝炎	疾病
胃脂肪瘤	疾病
注射用甲磺酸帕珠沙星	药物
盐酸黄酮哌酯	药物
反应性组织细胞增多症	疾病
人工流产术后出血	症状
叶酸片	药物
上眼睑增厚松弛	症状
养脾散	药物
铅管样强直	症状
健儿乐冲剂	药物
眶底骨折	疾病
可利肝冲剂	药物
美帕曲星	药物
哈拉西泮	药物
胃、十二指肠溃疡出血	疾病
昆明山海棠片	药物
房性心动过速伴房室传导阻滞	疾病
亮菌甲素	药物
甲状腺舌管囊肿与瘘	疾病
壮西六味丸	药物
复方水杨酸冰片软膏	药物
盐酸文拉法辛	药物
马尼地平	药物
克痢痧胶囊	药物
小儿慢性肾功能衰竭	疾病
戈舍瑞林	药物
硫酸奈替米星注射液	药物
脂质沉积性肌病	疾病
参茸三肾散	药物
涎腺小细胞癌	疾病
醋酸可的松	药物
右旋糖酐硫酸酯	药物
复方百部止咳糖浆	药物
腮腺炎减毒活疫苗	药物
血清醛缩酶同工酶	检查科目
上气道梗阻	疾病
软骨肉瘤	疾病
巴戟口服液	药物
复方丹茵膏	药物
胸壁深部软组织感染	疾病
小脑出血	症状
双唑泰泡腾片	药物
氨基酸代谢病	疾病
骨刺形成	症状
下肢肿胀和乏力	症状
阻塞性睡眠呼吸暂停综合征	疾病
苦参碱	药物
小儿星形细胞瘤	疾病
己二酸哌嗪	药物
踝部急性韧带损伤	疾病
肥大细胞增多症	疾病
耳源性眩晕	症状
氧分压	NoneType
玫果口服液	药物
梭形细胞血管内皮细胞瘤	疾病
情绪性失眠	症状
异烟肼注射液	药物
角菜酸酯	药物
颈静脉充盈	症状
安神补心丸	药物
心室扑动	症状
蒲公英冲剂	药物
支气管脓性分泌物增多	症状
维他利匹特N	NoneType
参芍片	药物
产后目病	疾病
肺良性淋巴细胞血管炎和肉芽肿病	疾病
喘络通胶囊	药物
表情淡漠	症状
呋喃西林止血膏布	NoneType
胃梅毒	疾病
血清补体C3裂解产物	NoneType
妥布霉素氯化钠注射液	药物
胫骨压痛	症状
注射用胞磷胆碱钠	药物
水盐代谢障碍	症状
酮洛芬片	药物
更年宁心胶囊	药物
疏风再造丸	药物
奇应内消膏	药物
呼吸气为尿臭味	症状
没食子酸丙酯	药物
蜂胶片	药物
便血	NoneType
乙肝灵丸	药物
卡马西平	药物
老年人夏伊-德雷格综合征	疾病
去氢胆酸片	药物
肾发育不全	疾病
血清免疫蛋白电泳	NoneType
磷酸氯喹	NoneType
腓肠肌撕裂	症状
马来酸依那普利分散片	药物
硫酸软骨素	药物
聚肌胞	药物
寒热痹胶囊	药物
抗骨增生胶囊	药物
颜面受累时褶皱加深形成“狮面”	症状
局部麻醉药中毒	疾病
围绝经期前后的外阴白色病变	疾病
杏芎氯化钠注射液	药物
人IgE酶标诊断试剂盒	药物
茶多酚	药物
脊柱病变性骨盆畸形	症状
鼻/鼻型T/NK细胞淋巴瘤	疾病
转氨酶异常增高	症状
清开灵注射液	药物
脑灰质移位	症状
布洛芬泡腾片	药物
经前舒颗粒	药物
骨硬化	症状
绿色尿	症状
脑脊液促甲状腺素	药物
局限性肾坏死	症状
眶静脉回流障碍	症状
盐酸格拉司琼分散片	药物
蛛网膜腔内囊肿	疾病
三子散	药物
胸壁软组织肿瘤	疾病
板蓝根糖浆	药物
口服酪酸梭菌活菌胶囊	药物
湄公血吸虫病	疾病
盐酸依匹斯汀片	药物
唇裂	疾病
小儿氨酚伪麻分散片	药物
胃窦炎	疾病
足掌痛	症状
乳癖消胶囊	药物
甘胆酸放免药盒	药物
突发性绞痛	症状
肋间隙可有压痛	症状
阴道异物	疾病
脑肝肾综合征	疾病
白喉性心肌炎	疾病
小儿心律失常	疾病
硫酸氯吡格雷	药物
隐匿型冠状动脉粥样硬化性心脏病	疾病
木瓜酶	药物
椎间盘钙化症	疾病
阿尼西坦分散片	药物
妊娠期间小便不通	症状
新生儿湿肺	疾病
妇可靖胶囊	药物
对乙酰氨基酚颗粒	药物
乳腺外上象限腺体增厚	症状
脉压差大	症状
迟萌	NoneType
肾前性肾功能不全	症状
指甲髌骨综合征	疾病
玻璃体及视网膜脱离手术所致青光眼	疾病
次硝酸铋	药物
消瘿气瘰丸	药物
棒杆菌属	细菌
萘敏维滴眼液	药物
毛发色淡而呈棕色	症状
可逆性氮质血症	疾病
肝脏病变弥漫	症状
银丹心泰滴丸	药物
口腔颌面部恶性淋巴瘤	疾病
清凉油	药物
阿莫西林克拉维酸钾分散片	药物
小儿百寿丸	药物
渗出性胸水	症状
头部偏向一侧做扭转运动	症状
速溶阿胶冲剂	药物
腰椎不稳	症状
低热消疲	症状
获得性免疫缺陷综合征的心血管损害	疾病
盐酸丙卡特罗胶囊	药物
无敌药酒	NoneType
桶状胸	症状
消糜栓	药物
产妇颈背酸痛	症状
小儿感冒片	药物
芎菊上清丸	药物
丁香风油精	药物
青紫舌	症状
眼眶肉瘤	疾病
复方双氯芬酸钠注射液	药物
毒品	病毒
椎体爆裂骨折	疾病
白血病伴发的精神障碍	疾病
清喉咽颗粒	药物
癫痫	疾病
颈康片	药物
外伤后头痛	疾病
虹膜异色	症状
金梅清暑颗粒	药物
失读	症状
磺胺嘧啶银乳膏	药物
红细胞染色质小体	检查科目
吡罗昔康	药物
四环素可的松眼膏	药物
依诺沙星片	药物
冠状动脉供血不足	症状
慢性腹泻	疾病
束支折返性室性心动过速	疾病
复方七叶皂苷钠凝胶	药物
参桂胶囊	药物
先天性主动脉缩窄	疾病
妊娠合并急性阑尾炎	疾病
红斑狼疮	疾病
丙型副伤寒菌诊断菌液	NoneType
竹沥水	NoneType
肌阵挛	症状
注射用促皮质素	药物
肝友胶囊	药物
磷酸氢二钠	药物
持续性疼痛	症状
腘血管陷迫综合征	疾病
延寄参胶囊	药物
小儿低心排出量综合征	疾病
安神补心颗粒	药物
锌中毒	疾病
维生素C缺乏病	疾病
侵袭性婴儿纤维瘤病	疾病
拉克替醇散	药物
痰湿阻肺	疾病
前列腺特异抗原(PSA)胶体金检测试纸条	NoneType
阿膜散	药物
血清鸟嘌呤酶	检查科目
反射弧中断	症状
老年人结核性脑膜炎	疾病
舒肝康胶囊	药物
特别容易饿	症状
清风油	NoneType
颅狭症	疾病
多潘立酮	药物
恒古骨伤愈合剂	药物
面肌瘫痪	疾病
药物相关性青光眼	疾病
逍遥片	药物
碘糖片	药物
洁身洗液	药物
蛇胆陈皮口服液	药物
茶碱麻黄碱胶囊	药物
三七通舒胶囊	药物
原发性视网膜色素变性	疾病
黄蛭益肾胶囊	药物
莲芝消炎滴丸	药物
体质性低血压	疾病
安胃颗粒	药物
拟除虫菊类农药中毒	疾病
通淋胶囊	药物
复方桔梗远志麻黄碱片I	药物
吲哚美辛软膏	药物
肾母细胞瘤	疾病
七宝美髯冲剂	药物
莲胆消炎颗粒	药物
口干燥症	疾病
遗传性出血性毛细血管扩张症	疾病
精子活动率	NoneType
茸坤丸	药物
辣椒风湿膏	药物
闭合性脊髓损伤	疾病
骨与关节结核	疾病
胰石病	疾病
脑室内出血	疾病
自由生活阿米巴感染	疾病
氮甲	药物
肛管内括约肌痉挛性收缩	疾病
复方胆通片	药物
灵孢多糖注射液	药物
甲羟松	药物
放射性甲状腺炎	疾病
硫酸链霉素注射液	药物
白色海绵状斑痣	疾病
羊水血性	症状
骨髓抑制	症状
注射用乙胺硫脲	药物
全身衰竭	症状
三七丹参颗粒	药物
格鲁米特	药物
感冒颗粒	药物
单纯疱疹性脑炎	疾病
肩部运动受限	症状
洁白胶囊	药物
壮骨伸筋胶囊	药物
血浆醛固酮	检查科目
阴道平滑肌肉瘤	疾病
格列喹酮片	药物
资生丸	药物
贝参平喘胶囊	药物
天麻头痛片	药物
西他沙星	药物
盐酸萘甲唑啉滴鼻剂	药物
阿莫西林克拉维酸钾咀嚼片	药物
数目较多的咖啡牛奶斑	症状
心音遥远	症状
联苯苄唑	药物
神经性头痛	症状
消化道狭窄	症状
胆道张力低下综合征	疾病
二盐酸奎宁注射液	药物
胸膜增厚粘连	症状
复方二氧丙嗪茶碱片	药物
酮洛芬搽剂	药物
石杉碱甲片	药物
牙列拥挤	症状
牡荆油丸	药物
脑脊液酸碱度值	检查科目
倒睫	症状
维生素B12滴眼液	药物
绿及咳喘颗粒	药物
脑垂体功能异常伴发的精神障碍	疾病
阿法骨化醇片	药物
甲钴胺片	药物
膝外侧韧带损伤	疾病
神志模糊	症状
腹部“气串样”肿块	症状
川贝枇杷颗粒	药物
水陆二仙丹	药物
上消化道出血	疾病
副流行性感冒	疾病
盐酸氟西汀肠溶片	药物
喉咽清口服液	药物
尿含铁血红黄素	检查科目
依西美坦胶囊	药物
硬脑膜下脓肿	疾病
嗅觉丧失	症状
透明血管型	症状
烟草环斑病毒	NoneType
紫雪丹	药物
冠心丹参片	药物
促卵泡成熟激素	NoneType
交替脉	症状
甘草酸单钾M	NoneType
爱普列特	药物
婴儿成神经细胞瘤	疾病
酸性磷酸酶染色	检查科目
喷替酸钙钠	药物
肾衰康灌肠液	药物
磷酸铝	药物
阴道白斑	疾病
小腿发胀	症状
颈部血管损伤	疾病
血清免疫球蛋白可升高	药物
强身酒	NoneType
旋转性眩晕	症状
乙肝清热解毒片	药物
双胃	疾病
抗艾滋病(AIDS)抗体	检查科目
头部震颤	症状
海藻糖酶缺乏	症状
跟骨骨骺骨软骨病	疾病
肘关节伸直位内翻角增大	NoneType
面部皮肤有结节状增生	症状
益气复脉片	药物
泻停封胶囊	药物
颠茄口腔崩解片	药物
大便色浅	症状
疖肿	NoneType
满山白胶囊	药物
生理性肥胖	症状
四边孔处的局限压痛	症状
复方保泰松鸡血藤片	药物
羟甲烟胺片	药物
复方石淋通片	药物
益母草口服液	药物
肾肝宁	药物
注射用呋布西林钠	药物
氯噻平	药物
胃移位	症状
获得性高脂蛋白血症	疾病
次水杨酸铋分散片	药物
消核片	药物
胃肠淋巴回流受阻	症状
唐氏综合征产前筛查系统	NoneType
营心丹	药物
眼白过白	症状
济众酊	药物
干呕	症状
早秃	疾病
盐蛇散	药物
甜梦胶囊	药物
注射用双黄连	药物
倍他洛尔	药物
恋尸型性变态	症状
胆石利通片	药物
午时茶颗粒	药物
牡蛎钙片	药物
阴囊瘙痒	症状
小儿室性心动过速	疾病
奥扎格雷钠注射液	药物
阳虚发热	疾病
五仁丸	药物
系膜毛细血管性肾小球肾炎	疾病
老年性紫癜	疾病
敖东壮肾丸	药物
盐酸洛美沙星葡萄糖注射液	药物
胸腺五肽	药物
异色性虹膜睫状体炎	疾病
复方鲜竹沥液	药物
眼眶嗜酸性肉芽肿	疾病
利尿八味散	药物
百梅止咳颗粒	药物
排出结石	症状
蜂胶牙痛酊	药物
84消毒液	药物
静脉注射用人免疫球蛋白(pH4)	药物
刚果红	药物
咽部硬结病	疾病
情绪性多汗症	症状
网膜肿瘤	疾病
甲磺酸二氢麦角碱片	药物
舒筋活血丸	药物
鼻孔干疼	症状
浅棕色斑点	症状
颈椎肥大	症状
七叶皂苷	药物
听骨畸形	症状
盐酸罗沙替丁醋酸酯	药物
周期性嗜睡强食症	症状
帕金森病性痴呆	疾病
产力异常性难产	疾病
维生素C口含片	药物
乳酸加替沙星葡萄糖注射液	药物
养血生发胶囊	药物
盆腔沉重感	症状
氨麻美敏片	药物
胸痛伴胸闷、心悸	NoneType
八味檀香丸	药物
回盲部结核	症状
乙酰吉他霉素含片	药物
复方蛋氨酸胆碱片	药物
硼酸洗液	药物
乳杆菌属	细菌
妇康宝口服液	药物
复方双花咀嚼片	药物
根痛平颗粒	药物
骨血管肉瘤	疾病
烧伤后肺栓塞	疾病
甲氧苄胺嘧啶片	药物
肝浸膏	药物
氯雷他定糖浆	药物
银黄分散片	药物
脐带感染	症状
共济失调型脑瘫	疾病
莱姆病性巩膜炎	疾病
五加参蛤蚧精	药物
芦笋菠萝蛋白酶胶囊	药物
眶脑膜瘤	疾病
氟罗沙星注射液	药物
五味甘露颗粒	药物
止咳化痰丸	药物
氯磷定注射液	药物
XV-现象	症状
出生时小头	症状
腹痛	NoneType
IV型胶原蛋白酶联免疫体外诊断试剂盒	药物
儿童精神运动发育异常	症状
蚓激酶肠溶胶囊	药物
珍黄丸	药物
喘泰颗粒	药物
脑活素	药物
氨金黄敏颗粒	药物
养血荣筋丸	药物
豆腐果素	NoneType
冻干静脉注射用人免疫球蛋白(pH4)	药物
颈椎黄韧带骨化症	疾病
山地岗感冒颗粒	药物
单眼眼前黑影	症状
泉州百草曲	NoneType
产后虚脱	疾病
依巴斯汀片	药物
注射用肌苷	药物
先天性风疹综合征	疾病
芪风颗粒	药物
乙型肝炎病毒表面抗体诊断试剂盒(酶联免疫法)	药物
黄水疮散	药物
藏茵陈颗粒	药物
血栓弹力图	检查科目
阿苯达唑咀嚼片	药物
刘元方	NoneType
空洞形成	症状
后天性动静脉瘘	疾病
硫酸延胡索乙素片	药物
和血明目片	药物
胃痛平胶囊	药物
肌苷片	药物
视神经撕脱	疾病
猩红热样红斑	疾病
肠系膜裂孔疝	疾病
食管类癌	疾病
异康唑	药物
小儿七珍丸	药物
断肢再植	疾病
CM1神经节苷脂贮积症	疾病
十一烯酸	NoneType
腰大肌阴影消失	症状
疱疹	NoneType
马来酸伊索拉定	药物
除痰止嗽丸	药物
胆红素	NoneType
舒灵喉片	药物
梅毒感染	症状
双侧手足徐动	症状
低氧血症	疾病
葡醛酸钠	药物
金咳息胶囊	药物
颅脑先天畸形	疾病
诺氟沙星锌	药物
喉气囊肿	疾病
红细胞生成性卟啉病	疾病
那他霉素滴眼液	药物
益心酮	药物
先天性白内障	疾病
局限性骨脓肿	疾病
下唇肿胀外翻	症状
清凉防暑冲剂	药物
清热解毒口服液	药物
氟烷	药物
肺热咳嗽	疾病
九华痔疮栓	药物
脑乐静糖浆	药物
氢溴酸烯丙吗啡注射液	药物
白蒲黄胶囊	药物
复方甘草酸单铵S注射液	药物
扭伤膏	药物
海蛇药酒	药物
桂附地黄丸(浓缩丸)	药物
遗传过敏性皮炎	疾病
风寒双离拐胶囊	药物
疱疹样天疱疮	疾病
甲亢灵片	药物
继发性皮肤CD30阳性大细胞淋巴瘤	疾病
氢溴酸山莨菪碱片	药物
腹膜间皮瘤	疾病
痹欣片	药物
醋羟胺酸胶囊	药物
尿糖	NoneType
磺溴酞钠注射液	药物
接骨七厘散	药物
异维A酸胶丸	药物
复方肝浸膏胶囊	药物
琥乙红霉素片	药物
椎管内神经鞘瘤	疾病
醋酸泼尼松龙	药物
肺血管炎	疾病
贝诺酯散	药物
耳道流血	症状
睡过之后精力没有恢复	症状
夜盲	症状
阿奇霉素氯化钠注射液	药物
他卡西醇	药物
舌头上有长时间不愈溃疡	症状
小儿右上腹阵发性绞痛	症状
丹参舒心胶囊	药物
伤风感冒冲剂	药物
小儿先天性高氨血症	疾病
肠梗死	症状
人工麝香	药物
水飞蓟宾胶囊	药物
大洛络丸	药物
注射用盐酸氨溴索	药物
乳宁颗粒	药物
美沙唑仑	药物
小儿粘连性肠梗阻	疾病
刺五加胶囊	药物
吞咽障碍	症状
手足徐动症	疾病
暴发性肝炎样综合征	疾病
念珠菌病	疾病
骨刺宁片	药物
吲哚美辛滴眼液	药物
中枢性呼吸暂停	症状
西洛他唑片	药物
复方苯甲酸软膏	药物
艾迪注射液	药物
小儿清热灵片	药物
善存银片	药物
小儿先天性甲状腺功能减低症	疾病
盐酸氨溴索分散片	药物
色素性静脉旁视网膜脉络膜萎缩	疾病
三花减肥茶	药物
精神发育迟滞	疾病
利米特罗	药物
假性幽门化生	症状
降糖舒胶囊	药物
注射用复方二氯醋酸二异丙胺	药物
氢溴酸右美沙芬胶囊	药物
内隐斜	疾病
血清谷草转氨酶	NoneType
松果体区占位病变	症状
肠道息肉病	疾病
溶菌酶含片	药物
托品酰胺	药物
同仁乌鸡白凤胶囊	药物
脂肉瘤	疾病
烧伤后瘢痕	疾病
心舒静吸入剂	药物
清热消炎宁胶囊	药物
喉疾灵片	药物
复方磷酸哌喹片	药物
外伤性硬膜下积液	疾病
慢性咽炎	疾病
昔萘酸沙美特罗气雾剂	药物
酒精伴发的精神障碍	疾病
蛇莲胶囊	药物
小儿柴芩清解颗粒	药物
梦游症	疾病
已酮可可碱注射液	药物
益气安神片	药物
氟硝西泮	药物
齿痛冰硼散	药物
匍行性血管瘤	疾病
磺胺甲噁唑	NoneType
醋酸去氨加压素	药物
翻身困难	症状
氢氧化铝片	药物
月骨脱位	疾病
家蚕核多角体病毒 SZ－1株	NoneType
安脑牛黄片	药物
丙硫异烟胺片	药物
异常矮小	症状
临产后阵痛剧烈	症状
小儿感冒舒颗粒	药物
抗感口服液	药物
三角肌疼痛	症状
胰激肽原酶肠溶片	药物
复方甲亢宁片	药物
牛黄消炎片	药物
喉部堵塞感	症状
维生素B12	药物
认识能力缺失	NoneType
脊椎炎	疾病
精神运动性兴奋	症状
肝胆湿热	疾病
婴儿肠痉挛	疾病
拉莫三嗪片	药物
皮肤湿毒	NoneType
脓性分泌物增多	症状
全血还原黏度	检查科目
二氧丙嗪	药物
特发性关节痛综合征	疾病
考登病中的多发性毛鞘瘤	疾病
脉络宁口服液	药物
急性右侧心力衰竭	疾病
寰椎沟环畸形	疾病
右旋布洛芬	药物
前列腺特异性酸性磷酸酶	检查科目
鳄皮婴儿综合征	疾病
脑穿通畸形	症状
视网膜病变	疾病
社交恐惧	NoneType
呕吐物吸入	疾病
静脉逗	NoneType
巴伦西亚分枝杆菌	NoneType
芩暴红止咳糖浆	药物
恩曲他滨片	药物
逍遥丸(浓缩丸)	药物
脑得生咀嚼片	药物
结、直肠黑变病	疾病
抗幽门杆菌IgG抗体	检查科目
丁酸氢化可的松	药物
布洛芬口腔崩解片	药物
三维肌醇片	药物
神农药酒	NoneType
天和追风膏	药物
良性反应性改变	症状
颞下颌关节外强直	疾病
双嘧达莫分散片	药物
疏风定痛丸	药物
C反应蛋白	检查科目
樟脑醑	药物
芙朴感冒颗粒	药物
小儿肾性氨基酸尿症	疾病
儿童遗粪症	疾病
痉挛性的肌张力增高	症状
壮骨关节丸	药物
血吸虫病	疾病
补骨脂注射液	药物
注射用促肝细胞生长素	药物
耳源性脑积水	疾病
银蒲解毒片	药物
口痛	症状
复方氨酚那敏颗粒	药物
室性并行心律及室性并行心律性心动过速	疾病
心宁片	药物
舒立通	药物
滋心阴口服液	药物
女金丸	药物
利巴韦林注射液	药物
清肝注射液	药物
戈那瑞林	药物
懒惰白细胞综合征	疾病
哕	疾病
清艾绒	NoneType
生发片	药物
阿奇霉素葡萄糖注射液	药物
十二指肠扩张	症状
小儿周期性高血钾性麻痹	疾病
桡骨小头骨折	疾病
奥昔康唑	药物
皮肤炭疽	疾病
肾盂肿瘤和输尿管肿瘤	疾病
“咳嗽水”上瘾	症状
右旋布洛芬片	药物
成釉细胞牙瘤及成釉细胞纤维牙瘤	疾病
潮式呼吸	症状
心脏重量增加	症状
甜菜碱	药物
黄斑病	疾病
金鳝消渴颗粒	药物
粪肠球菌	药物
盐酸米托蒽醌葡萄糖注射液	药物
咖啡酸片	药物
主动脉瘤	疾病
参茸片	药物
冻干马抗人IgE诊断红细胞	NoneType
寒热痹颗粒	药物
小儿病毒相关吞噬血细胞综合征	疾病
归芪养血糖浆	药物
复方炉甘石外用散	药物
营养性巨幼红细胞性贫血	疾病
压缩型骨折	症状
芎菊上清片	药物
乌诺前列酮	药物
马来酸罗格列酮片	药物
百令片	药物
弱蛋白银	药物
美羧伪麻胶囊	药物
藻酸双酯钠片	药物
颌骨发育过度	症状
急性肾炎	疾病
赖氨酸	药物
六味寒水石散	药物
健身宁片	药物
靶形红细胞	NoneType
杀人游戏	NoneType
盐酸洛美沙星氯化钠注射液	药物
脊髓出血性疾病	疾病
人参再造丸	药物
放射性肾炎	疾病
硫糖铝胶囊	药物
安那度尔注射液	药物
硝唑尼特	药物
北投姬天牛	NoneType
接触性睑皮炎	疾病
老年人类风湿性关节炎	疾病
牙颌面畸形	疾病
糖原染色	NoneType
野木瓜片	药物
神经元蜡样脂褐质沉积症	疾病
陶瑟征阳性	NoneType
老年人糖尿病肾病	疾病
外阴神经鞘瘤	疾病
痔特佳片	药物
环磷腺苷葡甲胺	药物
斑疹伤寒立克次体肺炎	疾病
复方骆驼蓬子软膏	药物
卡斯钦-贝克病	疾病
甘油果糖注射液	药物
胃恶性淋巴瘤	疾病
美沙拉秦	药物
腕关节扭挫伤	症状
副牛痘	疾病
儿童偏头痛	症状
夜尿宁	药物
金钱通淋颗粒	药物
先天性无子宫	症状
小儿慢性肉芽肿病	疾病
甲亢眼突	疾病
新生儿咽下综合征	疾病
口服脊髓灰质炎减毒活疫苗糖丸	药物
老年人心内膜炎	疾病
普罗布考	药物
除障则海甫片	药物
Rh血型不合	疾病
注射用重组人干扰素	药物
哌克昔林	药物
柠檬烯胶囊	药物
关节腔内出血	症状
肾血流量	检查科目
腭裂	症状
结节病	疾病
门冬氨酸	NoneType
网络综合症	疾病
沙眼衣原体肺炎	疾病
尸厥	疾病
胆茶碱	药物
紫椒癣酊	药物
腰疝	疾病
药用炭	NoneType
葛根岑连丸	药物
Q热	疾病
清热祛毒丸	药物
腹痛伴黄疸	症状
胰腺外分泌功能不良	症状
小儿先天性睾丸发育不全	疾病
真性菌尿	症状
肛门松弛	症状
炎立消片	药物
草豆蔻酊	药物
奉承心理	NoneType
百合固金丸	药物
结肠过敏症	疾病
右束支传导阻滞	疾病
家族性良性天疱疮	疾病
麦角胺咖啡因片	药物
双分伪麻片(成人片)	药物
肠病性肢皮炎综合征	疾病
带状疱疹病毒性巩膜炎	疾病
氯贝酸铝	NoneType
力克舒	药物
氢氯噻嗪可乐定片	药物
依沙酰胺	药物
《本经疏证》	NoneType
注射用紫杉醇脂质体	药物
卵巢纤维瘤病	疾病
阿曲库铵苯磺酸盐注射液	药物
小儿胱氨酸病	疾病
变性球蛋白(Heinz)小体染色试验	检查科目
布氏菌病	疾病
温中止泻丸	药物
奥沙利铂	药物
痔块脱垂	症状
大山楂咀嚼片	药物
西红花十六味散	药物
肉蔻五味丸	药物
乌金丸	药物
复方藿香片	药物
复方氨酚甲麻口服液	药物
绝经年龄过迟	症状
迁粉蝶浓核病毒	NoneType
益虚宁片	药物
参杞酒	NoneType
磷酸二氢钾	NoneType
氯化琥珀胆碱	药物
肘外翻	NoneType
蛇伤解毒片	药物
口服重组B亚单位/菌体霍乱菌苗肠溶胶囊	药物
盐酸双氧异丙嗪片	药物
复方清带灌注液	药物
山梨醇注射液	药物
麦味地黄合剂	药物
抗病毒咀嚼片	药物
未分化躯体形式障碍	症状
急性腰背部扭伤	疾病
预激综合征	疾病
甲癣	疾病
老年人播散性血管内凝血	疾病
小儿增食片	药物
胃疡宁丸	药物
手指痛风	症状
硝酸异山梨醇酯片	药物
八斑光鞘步甲	NoneType
希瓦氏菌属	细菌
维生素B6缺乏病	疾病
小儿混合性结缔组织病	疾病
鼻炎灵丸	药物
小儿尖端扭转型室性心动过速	疾病
氨甲苯酸葡萄糖注射液	药物
颅内压增高	NoneType
复方甘铋镁片	药物
小儿短指-球状晶体异位综合征	疾病
左羟丙哌嗪片	药物
总三碘甲状腺原氨酸	检查科目
跌打镇痛膏	药物
胎儿宫内发育迟缓	症状
嗅觉倒错	症状
急性根尖周炎	疾病
急性脊髓炎	疾病
蝶鞍变形	症状
脐膨出-巨舌-巨体综合征	疾病
复方磺胺嘧啶散	药物
副溶血弧菌	疾病
交沙霉素	药物
血小板活化因子	NoneType
额部肿块	症状
外阴脂肪瘤	疾病
妊娠纹	症状
木薯中毒	疾病
胰岛素样生长因子1	药物
乌鸡白凤口服液	药物
多肌炎	疾病
氨酚匹林咖啡因片	药物
腮腺无痛性肿块	症状
肥胖型人格	NoneType
龙胆苏打片	药物
银杏酮酯	药物
硫酸锌片	药物
银黄含片	药物
老年人急腹症	疾病
复方栀子气雾剂	药物
股神经损伤	疾病
胸痹心痛	疾病
二丁酰环磷腺苷钙	药物
肛管癌	疾病
高碘性甲状腺肿	疾病
参茸黑锡丸	药物
山绿茶降压片	药物
富马酸福莫特罗片	药物
骨化三醇	药物
抗核抗体(ANA)或抗核因子(ANF)	检查科目
牙本质瘤	疾病
锁骨骨折	疾病
器质性早泄	症状
肝脏局灶性结节性增生	疾病
少年儿童葡萄膜炎	疾病
脚底干裂	症状
小儿生血糖浆	药物
继发性甲状旁腺功能亢进症	疾病
注射用盐酸罂粟碱	药物
尿砷	检查科目
角化病	疾病
小儿先天性卵巢发育不全	疾病
碘苯酯	药物
前庭大腺癌	疾病
气功所致精神障碍	疾病
视觉失认	症状
先天性巨细胞包涵体病	疾病
小儿牛黄颗粒	药物
先天性髋内翻	疾病
髌后捻发音	症状
真菌性心包炎	疾病
伤科七味片	药物
小儿四症丸	药物
嗜碱性粒细胞增多症	疾病
天龙熄风颗粒	药物
早晨上下眼睑粘连	NoneType
十四味疏肝胶囊	药物
益心口服液	药物
阑尾周围脓肿	症状
特发性低促性腺激素性性腺功能减退症	疾病
神经卡压综合征	疾病
坏死性龈口炎	疾病
面肌抽搐	症状
鲍恩病	疾病
结核性脊髓炎	疾病
茯菟丸	药物
桑菊感冒颗粒	药物
腹鸣	症状
灵芝桂圆酒	药物
胸痛伴呼吸困难	症状
遗传性粪卟啉病	疾病
云南白药酊	药物
抗中性粒细胞胞浆	检查科目
帕金森病	疾病
复方铝酸铋片	药物
二氧化碳分压	NoneType
食管肉瘤	疾病
长时间或剧烈运动后前足疼痛	症状
双密达莫	NoneType
硫酸核糖霉素注射液	药物
忍冬感冒颗粒	药物
轻身消胖丸	药物
舍雷肽酶肠溶片	药物
苯甲酸雌二醇软膏	药物
雷络酯片	药物
唾液链球菌	细菌
醒后不解乏	症状
已酸羟孕酮注射液	药物
咽喉及口内刺痒	症状
肺结核	疾病
聚甲酚磺醛阴道栓	药物
氯化钾环戊噻嗪缓释片	药物
单硝酸异山梨酯滴丸	药物
胆囊增大	症状
手腕长骨刺	症状
低分子肝素钠注射液	药物
消炎镇痛膏	药物
复方益智补肾口服液	药物
健脾五味丸	药物
立克次体补体结合试验	检查科目
智杞颗粒	药物
补肾斑龙片	药物
清凉止痒搽剂	药物
血塞通滴丸	药物
氨酚美芬伪麻分散片	药物
稚儿灵膏滋	NoneType
脑血吸虫病	疾病
杞菊地黄合剂	药物
盐酸罗通定	药物
首乌强身片	药物
痘疤	症状
加替沙星氯化钠注射液	药物
泻肝安神丸	药物
液脱	疾病
百日咳菌苗	药物
常染色体隐性遗传性脑动脉病及动脉硬化伴皮质下梗死及白质脑病	疾病
泮托拉唑钠肠溶片	药物
胶原酶	药物
十全大补膏	药物
面部多毛	症状
截瘫	症状
复方甘草铝镁片	药物
鞍鼻	症状
科博肽注射液	药物
黏膜白色海绵状痣	NoneType
头孢克肟干混悬剂	药物
氟芬那酸	药物
脑脊液氨基酸	检查科目
血胸	疾病
红细胞机械性脆性试验	检查科目
尿维生素B2	药物
沉香舒郁片	药物
边缘溃疡性角膜炎	疾病
肾石通颗粒	药物
下肢呈剪刀步态	症状
大黄通便胶囊	药物
盐酸贝那替秦片	药物
嗜热脂肪芽孢杆菌	NoneType
肿瘤	疾病
抗核仁抗体	检查科目
颌面骨结核	疾病
注射用头孢噻肟钠	药物
急性后部多灶性鳞状色素上皮病变	疾病
鱼腥草素钠	药物
复方紫草油	药物
X联锁鱼鳞病	疾病
三羟黄酮	药物
枸橼酸氯米芬胶囊	药物
甲氯噻嗪	药物
复方桔梗麻黄碱糖浆	药物
枸橼酸钙咀嚼片	药物
牙齿异常	症状
全身过敏和发热皮疹关节痛	症状
脑萎	疾病
八正颗粒	药物
全身性特发性毛细血管扩张症	疾病
复方半边莲注射液	药物
阿普唑仑片	药物
盐酸尼卡地平氯化钠注射液	药物
先天性胆管囊状扩张	疾病
滋肾宁神丸	药物
遗尿	疾病
痹通药酒	NoneType
阴道上皮内瘤样变	疾病
云南花粉片	药物
强迫观念	症状
粘液便	症状
小儿肝炎颗粒	药物
元胡止痛软胶囊	药物
甘草酸氯丙那林含片	药物
盐酸艾司洛尔注射液	药物
烧伤后恶心与呕吐	症状
近端肾小管性酸中毒	疾病
疏肝益阳胶囊	药物
杏苏合剂	药物
三磷酸胞苷二钠氯化钠注射液	药物
网状青斑和坏疽	症状
小儿急性血行播散型肺结核	疾病
盐酸奈福泮葡萄糖注射液	药物
蝎子螫伤	疾病
跌打片	药物
龟分枝杆菌感染	疾病
三味泻痢颗粒	药物
尼莫地平	药物
阵挛	症状
氯霉素滴耳液	药物
乙状结肠造口旁沟疝	疾病
痔康胶囊	药物
凉结节	症状
大疱（含脓性液体）	NoneType
氯芬待因复方片	药物
伊拉地平	药物
胃节律紊乱综合征	疾病
二尖瓣脱垂综合征	疾病
乳腺错构瘤	疾病
珍珠明目滴眼液	药物
醋酸倍他米松搽剂	药物
酚明伪麻片	药物
颈部扭伤	症状
牙齿缝隙大	症状
金鹃咳喘停合剂	药物
六味枸杞口服液	药物
新福菌素	NoneType
四肢远端麻木、疼痛或异样感觉	NoneType
旅游者腹泻	疾病
靛胭脂	药物
滴通鼻炎水	药物
利福平滴眼液	药物
强骨生血口服液	药物
降压袋泡茶	药物
复方皂矾片	药物
注射用异烟肼	药物
手凉	症状
仙乐雄胶囊	药物
肺部少见的恶性肿瘤	疾病
养心达瓦依米西克蜜膏	药物
银黄片	药物
绿猴病	疾病
十一味黄精颗粒	药物
紫菜炒鸡蛋	NoneType
高脂蛋白血症Ⅴ型	NoneType
牙齿黑斑	症状
美他环素	药物
安络痛片	药物
钆双胺	药物
原发性婴幼儿型青光眼	疾病
抗腮腺炎注射液	药物
胆汁槟榔维B1胶囊	药物
噪声性耳聋	疾病
骨外骨肉瘤	疾病
筋痛消酊	药物
脑蛋白水解物	NoneType
氦-3	NoneType
精制猴枣散	药物
桂林西瓜霜	药物
老年人无症状性心肌缺血	疾病
左金片	药物
高卢根瘤菌	NoneType
呋塞米注射液	药物
关节强直	症状
润伊容口服液	药物
腹痛水	药物
口唇麻木	症状
阿胶三宝颗粒	药物
纵隔浊音界扩大	症状
胸、腰椎椎体单纯性、楔形压缩骨折	疾病
静止性震颤	症状
窦房传导阻滞	疾病
氨酪酸	药物
情绪性进食	症状
西曲溴铵	药物
消肿痛醋膏	药物
复方茶酮缓释片	药物
复方双氢青蒿素片	药物
米非司酮	药物
反射性神经障碍症	疾病
麻风	NoneType
羟氯喹	药物
脑桥小脑角综合征	疾病
灯银脑通胶囊	药物
粘液腺体肥大	症状
UAT测试	NoneType
复方枇杷氯化铵口服液	药物
里急后重	症状
小儿肾静脉血栓形成	疾病
磷酸素钠甲氧苄啶胶囊	药物
汽油中毒	疾病
血浆环磷酸腺苷	检查科目
氨愈美麻分散片	药物
萘普生颗粒	药物
盐酸西布曲明	药物
根瘤菌属	细菌
缺智齿	症状
新生儿单纯疱疹病毒感染	疾病
复方醋酸地塞米松乳膏	药物
连花清瘟胶囊	药物
全身皮肤充血	症状
盐酸曲马多	药物
盐酸奥昔布宁口服溶液	药物
痔疮	疾病
松龄血脉康胶囊	药物
飞扬肠胃炎片	药物
盐酸氨基葡萄糖胶囊	药物
十味玉泉胶囊	药物
桡骨茎突剧痛	症状
食道粘膜水肿充血	症状
十二指肠腺癌	疾病
百部丸	药物
杏香兔耳风片	药物
伤疖膏	药物
博落回肿痒酊	药物
反胃	NoneType
结核性苔藓	疾病
抗角蛋白抗体	检查科目
良性淋巴细胞血管炎和肉芽肿病	疾病
双红活血胶囊	药物
羟孕酮	药物
福尔可定片	药物
盐酸甲氧明	药物
迟发性皮肤卟啉病	疾病
假麦格综合征	疾病
吟诗样语言	症状
乳晕深部可扪及肿块	症状
金龙胆草浸膏片	药物
色素性胆结石	症状
一过性红斑狼疮样	症状
频吐白沫	症状
慢性胃痛	症状
小儿肾性糖尿	疾病
脚上血泡	症状
复方二氢麦角隐亭A	药物
吞咽痛	症状
止嗽片	药物
化瘀丸	药物
积乳囊肿	疾病
溶骨性损害	症状
视网膜下新生血管膜	疾病
五酯微丸	药物
胃良性肿瘤	疾病
脾肾双补丸	药物
川字纹	NoneType
贞芪利咽颗粒	药物
依来曲普坦	药物
散风活络丸	药物
处女膜闭锁	疾病
猩红热	疾病
阿米巴结肠炎	疾病
羚羊清肺散	药物
血浆游离血红蛋白	检查科目
小儿阿姆斯特丹型侏儒	疾病
麻痹性斜视	疾病
泪液分泌型免疫球蛋白A	药物
硫磺	药物
咳速停胶囊	药物
肝维康片	药物
局限性肌张力障碍	症状
胎儿乙醇综合征	疾病
舌苔黄	症状
慢性根尖周炎	疾病
碳酸钙	NoneType
亮菌糖浆	药物
高泌乳素血症	疾病
氯霉素	NoneType
气喘	症状
二尖瓣狭窄	疾病
毛发上皮瘤	疾病
龟芪参口服液	药物
氟康唑胶囊	药物
血卟啉病	疾病
痔炎消胶囊	药物
川花止痛膜	药物
脑脊液梅毒血清补体结合反应	NoneType
二甲弗林	药物
肝肾膏	药物
吉兰巴雷综合征	疾病
脑立清	NoneType
老年心肌病	疾病
复方木香铝镁	药物
胆管扩张症	疾病
烟草色纤孔菌	NoneType
舒痔丸	药物
皮肤有瘙痒抓痕	症状
贝美格注射液	药物
心达康分散片	药物
肝病	疾病
血塞通颗粒	药物
蕈状芽孢杆菌	NoneType
宁心安神胶囊	药物
骨骺点状发育不良	疾病
磺胺嘧啶	NoneType
猪细小病毒	NoneType
小儿泻速停颗粒	药物
葡萄糖酸钙口服液	药物
放线菌素D	药物
口腔菜花状乳头瘤病	疾病
葡萄糖酸镁颗粒	药物
躯体依赖性	症状
筋骨草片	药物
盐酸去甲万古霉素	药物
骨质疏松	NoneType
风痹	疾病
海昆肾喜胶囊	药物
婴儿脊柱侧凸	症状
膝内翻膝外翻或髋内翻	症状
银翘片	药物
自律性房性心动过速	NoneType
注射用盐酸氯普鲁卡因	药物
黑斑	症状
睑结膜硬而扁平的乳头	症状
珍珠牛黄散	药物
胆道蛔虫病	疾病
奥沙普秦胶囊	药物
血清丁醇提取碘	NoneType
双肾皮质变薄	症状
辅酶Q10片	药物
小儿暑温	疾病
泼尼松龙	NoneType
龙胆碳酸氢钠片	药物
十味扶正颗粒	药物
青蒿素	药物
注射用盐酸溴己新	药物
外阴疣状黄瘤	疾病
深睡眠症	疾病
四肢呈对称性下运动神经元性瘫痪	症状
甲基硫氧嘧啶片	药物
老年人代谢性酸中毒	疾病
安宫降压丸	药物
手臂肌肉拉伤	症状
小儿腹泻宁	药物
复发性线性棘层松解性皮肤病	疾病
心脏钝性闭合伤	疾病
虎驹乙肝片	药物
催乳素瘤	疾病
糖原累积症	疾病
流感嗜血杆菌脑膜炎	疾病
红色盲	症状
无味黄连素	NoneType
蟾乌巴布膏	药物
米力农葡萄糖注射液	药物
明目拨云散	药物
灵宝护心丹	药物
遗忘综合征	疾病
盐酸氯胺酮注射液	药物
白大衣高血压	疾病
熊胆滴丸	药物
海马万应膏	药物
蝎毒注射液	药物
化脓性腮腺炎	疾病
进行性肥厚性间质性神经炎	疾病
盐酸克林霉素棕榈酸酯颗粒	药物
氯化钙	NoneType
阿昔单抗	药物
妇女雄激素源性秃发	疾病
托美丁钠	药物
脊髓受压	症状
肾脏受累	症状
清咽抑火丸	药物
横膈下结肠嵌入综合征	疾病
急性视网膜色素上皮炎	疾病
牛肺表面活性提取物	药物
盐酸精氨酸注射液	药物
复方林非妥片	药物
马来酸曲美布汀分散片	药物
阿胶远志膏	药物
口腔白色角化病	疾病
胰岛细胞膜抗体	检查科目
肾上腺髓质增生	疾病
复方木芙蓉涂鼻膏	药物
孕妇金花胶囊	药物
氢化可的松	NoneType
前庭大腺炎	疾病
九一散	药物
维生素E	药物
萘丁美酮分散片	药物
黏液分泌亢进	症状
小儿肺水肿	疾病
肝脏轻度脂肪变性	症状
儿童胰腺功能不全并中性粒细胞减少症综合征	疾病
足部肿胀压痛	症状
联苯双酯滴丸	药物
碘番酸片	药物
乙型肝炎病毒表面抗原胶体金检测试纸	NoneType
普罗帕酮	药物
苯扎氯铵贴	药物
香砂养胃颗粒	药物
益肝明目口服液	药物
氟哌利多	药物
巴柳氮二钠	药物
生白颗粒	药物
保和冲剂	药物
生肌玉红膏	药物
浅筋膜炎	疾病
坤复康胶囊	药物
盐酸苯乙双胍	药物
参茸复春片	药物
脑脊液精氨酸加压素	检查科目
非那西丁	药物
槟榔四消片	药物
乙型肝炎病毒e抗原诊断试剂盒(放射免疫法)	药物
十二烷基硫酸钠Hb测定法	检查科目
颈动脉体瘤	疾病
手参肾宝胶囊	药物
加兰他敏	药物
消炎退热合剂	药物
薯蓣皂苷片	药物
通宣理肺口服液	药物
奈法唑酮	药物
强力天麻杜仲丸	药物
玉液消渴颗粒	药物
克拉霉素缓释胶囊	药物
右室肥厚	症状
胰胚抗原	检查科目
氮质血症	疾病
脉沉缓或沉细	症状
心内膜弹性纤维增生症	疾病
满山红油滴丸	药物
角膜上皮糜烂	症状
半侧面部发育不良	症状
真两性畸形	疾病
盐酸利多卡因凝胶	药物
活血舒筋酊	药物
微球菌	NoneType
颞下颌关节病	疾病
宫炎平片	药物
西园喉药散	药物
口蹄疫	疾病
阿仑膦酸钠片	药物
硫喷妥钠	药物
大黄酊	药物
婴儿猝死综合征	疾病
参芪健胃冲剂	药物
白痧散	药物
小肠类癌	疾病
养阴降压胶囊	药物
氟康唑注射液	药物
双氯芬酸钠缓释微丸	药物
复合磷酸酯酶肠溶片	药物
特异性心肌病	疾病
夫西地酸钠	药物
老年人病毒性肝炎	疾病
灵杆菌素	药物
胎膜破裂	症状
安喘片	药物
抗A抗B血型定型试剂(单克隆抗体)	药物
心脏横纹肌瘤	疾病
小儿Alstrom综合征	疾病
外阴癌	疾病
异喹胍	药物
虎梅含片	药物
建参片	药物
增生性瘢痕	症状
乙肝扶正胶囊	药物
地西泮膜	NoneType
七星茶	药物
耐酪酸冢村菌	NoneType
乳癖舒胶囊	药物
先天性高位肩胛	疾病
甲硝唑维B6片	药物
大黄通便颗粒	药物
皮肤粘连	症状
甲氧氟烷	药物
褥疮	疾病
脂必妥片	药物
鼻源性头痛	NoneType
基因融合	症状
小儿复方磺胺嘧啶颗粒	药物
乌金口服液	药物
游离甲状腺素	检查科目
生肌散	药物
眼眶脑膜-脑膨出	疾病
柏子养心片	药物
通络止痛药酒	药物
龟鹿二胶丸	药物
溴甲贝那替秦	药物
沟裂增宽	症状
单纯性雀斑样痣	疾病
腰背酸痛	症状
脓疱型银屑病	疾病
咽舒口服液	药物
牙龈肿胀	症状
仙鹿口服液	药物
醋丁洛尔	药物
硫酸粘菌素片	药物
门冬氨酸鸟氨酸	药物
穿心莲丸	药物
卵巢透明细胞肿瘤	疾病
硼酸氧化锌冰片软膏	药物
匹考哌林	药物
乳腺钙化	症状
新生儿锁骨骨折	疾病
养胃舒胶囊	药物
安宫牛黄胶囊	药物
胆康片	药物
囊肿样改变	症状
高碳酸血症	疾病
泌尿生殖系损伤	疾病
阿芙蓉	药物
哭泣样尖叫	NoneType
白带检查	检查科目
小儿泄泻停颗粒	药物
碘苷	药物
贫血伴发的精神障碍	疾病
解淀粉芽孢杆菌	NoneType
补虚通瘀颗粒	药物
按摩乳	药物
追风除湿酒	NoneType
唇齿清胃丸	药物
小儿良友散	药物
颌骨骨髓炎	疾病
种植体周围病变	疾病
复方丹蛭片	药物
比沙可啶栓	药物
外伤性腹膜后出血或血肿	疾病
硫酸阿米卡星氯化钠注射液	药物
洋地黄毒苷	药物
乙型脑炎灭活疫苗	药物
肝苏胶囊	药物
单硝酸异山梨酯缓释胶囊	药物
谷氨酸钾	药物
玫瑰色盐水球菌	NoneType
性冷淡	疾病
Barrett食管	疾病
颈痛胶囊	药物
运动后尿血	症状
皮肤过敏	NoneType
阿法骨化醇	药物
妊娠痒疹	症状
腹部皮肤梅干样皱纹	症状
氯唑西林钠胶囊	药物
咽喉干燥充血	症状
老年人低血糖症	疾病
白细胞尿	症状
热炎宁胶囊	药物
眼前冒金花	症状
肝硬化男性性功能减弱综合征	疾病
重组人白细胞介素2注射液	药物
丁苯酞软胶囊	药物
肿痛凝胶	药物
慢性肺炎	疾病
盐酸林可霉素滴耳液	药物
特非那定分散片	药物
安脑牛黄胶囊	药物
急性早幼粒细胞白血病	疾病
聚维酮碘泡腾片	药物
腭异常	症状
坏死性筋膜炎	疾病
磷酸咯啶	药物
烧伤败血症	疾病
莫西赛利	药物
气秘	NoneType
肺内圆形实质性或囊性肿块	症状
小儿胃宝丸	药物
痛经片	药物
视野向心性缩小	症状
泰脂安胶囊	药物
原发性心脏肿瘤	疾病
角膜表面三角形胬肉	症状
热汗	疾病
盐酸阿扑吗啡注射液	药物
曲克芦丁胶囊	药物
妇炎消胶囊	药物
复方醋酸曲安奈德溶液	药物
脐带脱落后伤口不愈并溢液	症状
阴道入口粘膜撕裂	症状
毛发稀少	症状
急性梗阻性化脓性胆管炎	疾病
心安宁片	药物
丙酮酸激酶缺乏症	疾病
乳疬	疾病
眼眶黏液囊肿	疾病
定喘止咳胶囊	药物
骨包囊虫病	疾病
产妇安丸	药物
心房内折返性心动过速	疾病
复方金刚烷胺氨基比林片	药物
甲磺酸酚妥拉明颗粒	药物
胶冻样芽孢杆菌	NoneType
牙源性皮瘘	疾病
食物过敏	症状
小儿尼曼-皮克病	疾病
红斑型天疱疮	NoneType
紫金散	药物
排尿障碍	症状
葶苈降血脂片	药物
胸腹主动脉动脉瘤	疾病
络瘀通胶囊	药物
盐酸司来吉兰	药物
肿瘤科	医学专科
口腔溃疡	症状
小儿急性支气管炎	疾病
胁痛	疾病
鼻塞	症状
鼻子黄色或棕色	症状
注射用果糖	药物
网膜囊肿扭转	症状
乙氧苯柳胺	药物
复方天麻颗粒	药物
二巯丙醇注射液	药物
牛黄醒消丸	药物
嵌顿性腹股沟斜疝	疾病
隐斜	疾病
四季油	NoneType
复方沙棘籽油栓	药物
盐酸消旋山莨菪碱注射液	药物
鼻窦气压性创伤	疾病
婴儿安片	药物
结核性脑膜炎	疾病
维胺酯维E乳膏	药物
泡性角结膜炎	疾病
外源性变应性肺泡炎	疾病
乳结康丸	药物
风湿药丸	药物
喷昔洛韦	药物
以偷窥为快感源泉的性变态	NoneType
急性胆囊炎	疾病
房室交接区性期前收缩	疾病
胍基化合物	NoneType
急性肾衰竭	NoneType
骨髓象改变	症状
三凹征	症状
聚苯乙烯磺酸钙散	药物
脾胃不和	症状
盆腔疾病	疾病
胃灵冲剂	药物
生脉片	药物
小儿脆性X染色体	疾病
喜字阿胶	药物
距骨骨折脱位	疾病
重症联合免疫缺陷	疾病
水、电解质紊乱伴发的精神障碍	疾病
苛桠素	药物
盐酸阿米替林	药物
喉血管瘤	疾病
胫骨远端爆裂骨折	疾病
注射用阿奇霉素枸橼酸二氢钠	药物
莫匹罗星软膏	药物
地氟烷	药物
健身安胎丸	药物
血风疮	疾病
苯巴比妥东莨菪碱片	药物
倾倒综合征	疾病
喉头水肿	症状
髌后疼痛	症状
千柏鼻炎片	药物
环丙烷	药物
粪颜色	检查科目
盐酸丁丙诺啡片	药物
乳糖酸红霉素	药物
喜讲秽语	NoneType
血红蛋白C病	疾病
健康补肾酒	NoneType
噪声病	疾病
C群脑膜炎奈瑟氏菌诊断试剂(单克隆抗体)	NoneType
大便失禁	NoneType
盐酸普萘洛尔注射液	药物
横结肠扭转	疾病
传染性脓疱病	疾病
注射用克林霉素磷酸酯	药物
盐酸克伦特罗栓	药物
注射用盐酸维拉帕米	药物
踝关节屈曲挛缩畸形	症状
妊娠合并甲状旁腺功能减退	NoneType
转移性小肠肿瘤	疾病
善变副球菌	NoneType
关节肿胀	症状
肩痹膏	药物
老年人慢性肾盂肾炎	疾病
养血安神糖浆	药物
骨血管内皮细胞瘤	疾病
肋骨及胸骨下吸入性凹陷	症状
富马酸氯马斯汀口服溶液	药物
镇咳糖浆	药物
补肾班龙片	药物
五海丸	药物
外阴阿米巴病	疾病
脑外科	医学专科
痔疮片	药物
牙体损伤	症状
复方枸橼酸喷托维林颗粒	药物
强迫蹲位	症状
安替比林	NoneType
颈肩痛	症状
黑加仑油	NoneType
血清游离甘油	检查科目
雏凤精	NoneType
下腔静脉血栓形成	症状
副肿瘤性边缘系统脑炎	疾病
白塞病	疾病
乙型肝炎病毒核酸及YMDD变异检测试剂盒	药物
氯唑沙宗	药物
氟吗西尼注射液	药物
小儿异染性脑白质营养不良	疾病
侵蚀性骨破坏	症状
八字脚步态	症状
外耳道疖肿	疾病
猪水疱疹病毒 	NoneType
复发性无菌性脑膜炎	疾病
明目二十五味丸	药物
安嗽糖浆	药物
妇康宝合剂	药物
妇女多毛症	疾病
蛇胆南星散	药物
二氮嗪注射液	药物
耳漏	症状
猕猴桃颗粒	药物
舒必利片	药物
吉法酯	药物
盐酸川芎嗪	药物
浅感觉减退或缺失	症状
周期性麻痹	疾病
己酸羟孕酮	药物
弹性酶	药物
上肢半屈状	症状
血清游离胆固醇	NoneType
无水葡萄糖	药物
卵巢纤维组织来源肿瘤	疾病
骨纤维异常增殖症	疾病
宜肝乐颗粒	药物
急性骨髓性白血病	疾病
单纯性乳腺增生症	疾病
先天性膀胱颈挛缩	疾病
抗丁型肝炎病毒IgM抗体	检查科目
上颌骨骨折	疾病
脂欣康颗粒	药物
药制龟苓膏	药物
单硝酸异山梨酯缓释小丸	药物
特征性回归热	症状
苁蓉益肾颗粒	药物
康复灵栓	药物
夏伊-德雷格综合征	疾病
复方蛇胆川贝末	药物
盐酸柔红霉素	药物
肺心夏治胶囊	药物
西司他丁钠	药物
肿瘤相关抗原	检查科目
羊水与尿液鉴别试验	检查科目
颞骨岩部炎	疾病
氨肽素片	药物
急性脓胸	疾病
沙门氏菌	症状
痛舒片	药物
扳机指的弹响	症状
杜仲平压胶囊	药物
丙酸倍氯米松鼻气雾剂	药物
痹克颗粒	药物
鼻渊糖浆	药物
月经失调性不孕症	疾病
新生儿急性肾功能衰竭	疾病
风湿性多发性肌痛症	疾病
健脑补肾丸	药物
皮肤恶性黑色素瘤	疾病
雪胆素胶囊	药物
阿德福韦酯	药物
心脑宁胶囊	药物
流行性角膜结膜炎	疾病
黄连解毒丸	药物
睫状体黑色素瘤	疾病
涎腺黏液囊肿	疾病
交叉性异位肾	疾病
红霉素栓	药物
手足多汗	症状
小儿血管-骨肥大综合征	疾病
子宫肥大	疾病
肝包虫囊肿	疾病
盐酸西替利嗪糖浆	药物
钟南山	NoneType
创伤性骨髓炎	疾病
吸附无细胞百日咳疫苗	NoneType
周边葡萄膜炎	疾病
杜波组织胞浆菌病	疾病
小儿脾大	NoneType
碘源性甲亢	NoneType
维生素AE胶丸	药物
甲氧明	药物
乳酸左氧氟沙星片	药物
阿糖腺苷	药物
眼球内积脓而失明	症状
回归热	疾病
西那卡塞	药物
眼球内陷	疾病
茶碱	NoneType
视束病变	疾病
复方妥洛特罗糖浆	药物
胆炎康胶囊	药物
左旋多巴注射液	药物
磺胺嘧啶银	NoneType
赖氨葡锌颗粒	药物
抗甲状腺抗体	检查科目
恶性骨肿瘤	疾病
低位腰痛	症状
竹沥膏	药物
猴头菌片	药物
胰岛素	NoneType
肾小球基底膜蛾噬现象	症状
思维松弛	NoneType
臀部可触及上移的股骨头	症状
青石冲剂	药物
耳后疼痛	症状
小儿保安丸	药物
齐墩果酸	药物
药墨	药物
大枫子油	药物
小儿槭糖尿病	疾病
滴鼻用安乃近溶液片	药物
升白新	药物
健肺丸	药物
硫酸丁胺卡那霉素注射液	药物
胃痛	NoneType
腹股沟滑动疝	疾病
心脏穿透性损伤	NoneType
肥儿疳积颗粒	药物
叶绿素铜钠	药物
感冒消炎片	药物
地夫可特	药物
地衣芽孢杆菌胶囊	药物
桂附地黄丸浓缩丸	药物
妊娠合并慢性肾小球肾炎	疾病
遗传性抗凝血酶Ⅲ缺乏症	疾病
复方倍氯米松新霉素贴膏	药物
血色病性心肌病	疾病
铁树	NoneType
肝星状细胞增生	症状
葡萄糖酸钙片	药物
焦楂化滞丸	药物
丙肝病毒抗体酶联免疫测定试剂盒	药物
咳嗽伴胸痛	症状
七叶神安片	药物
加巴喷丁	药物
苯替酪胺	药物
流泪	症状
婴儿玫瑰疹	疾病
安神补脑颗粒	药物
甲溴贝那替秦片	药物
注射用乳酸诺氟沙星	药物
新生儿窒息	疾病
托特罗定	药物
皮肤穿入性毛囊和毛囊周角化病	疾病
玉屏风丸	药物
亚急性坏死性脊髓炎	疾病
十味活血丸	药物
贯黄感冒颗粒	药物
珠黄消疳散	药物
依索唑胺	药物
高弓足	NoneType
奥沙尼喹	药物
促卵泡激素放免药盒	药物
噫气	疾病
双氯非那胺片	药物
输卵管狭窄	疾病
复方庚酸炔诺酮注射液	药物
躯体感染伴发的精神障碍	疾病
肋骨融合	症状
减肥通圣片	药物
盐酸赛庚啶片	药物
醋酸曲安西龙尿素乳膏	药物
注意力不集中	症状
特发性肺纤维化	疾病
桂芍镇痫片	药物
二羟丙茶碱葡萄糖注射液	药物
二羟丙茶碱注射液	药物
熟三七散	药物
柴胡镇咳片	药物
鼻窦气压伤	NoneType
注射用唑来膦酸	药物
红细胞比容	NoneType
须疮	疾病
补脑丸	药物
十全大补口服液	药物
皮肤松弛起皱	症状
养阴降糖片	药物
先天性尺骨缺如	疾病
皮肤硬化	症状
鼻炎糖浆	药物
复发性多软骨炎	疾病
咳欣康片	药物
先天性小喉	疾病
胆囊类癌	疾病
橘红痰咳冲剂	药物
不能露齿及突唇	症状
十字韧带损伤	疾病
二十五味竺黄散	药物
芩苓子阴道灌注液	药物
脑脊液颜色	检查科目
脊髓前动脉综合征	疾病
脑干损伤	疾病
眼睑松弛和上唇增厚	症状
黑色素斑-胃肠多发性息肉综合征	疾病
硫酸长春地辛	NoneType
健步壮骨丸	药物
沙棘颗粒	药物
脑血疏口服液	药物
奥利司他	药物
老年人酒精性肝病	疾病
胃炎宁冲剂	药物
指(趾)肿胀	症状
豹骨酒	NoneType
产褥期幻觉妄想状态	症状
郁冒	疾病
纵隔淋巴结增生	症状
复方锌布颗粒	药物
厥脱	疾病
罗红霉素	药物
清胃止痛微丸	药物
润肤丸	药物
心动过速性心肌病	疾病
病毒性食管炎	疾病
链佐星	药物
丹参颗粒	药物
盐酸丁咯地尔片	药物
奥沙米特	药物
肝肺综合征	疾病
芫蒿护肝片	药物
肱骨远端全骺分离	疾病
眼外肌发育不全	疾病
丙硫异烟胺	药物
心脏杂音	症状
通络祛痛膏	药物
醋酸洗必泰栓	药物
银屑灵颗粒	药物
风湿定片	药物
湿热痹片	药物
磺胺嘧啶片	药物
血友病乙	疾病
小建中颗粒	药物
注射用甲氧异腈	药物
美托洛尔	NoneType
手指不能屈伸	症状
眼压升高	症状
异福酰胺胶囊	药物
痛风石	疾病
黏膜稍苍白	症状
咳喘宁颗粒	药物
氨咖愈敏溶液	药物
胃肠食物不耐受症	疾病
胃安胶囊	药物
疖	疾病
胆囊积脓	症状
冻干布氏菌诊断血清	NoneType
堪萨斯分枝杆菌感染	疾病
复芪止汗颗粒	药物
过敏性休克	疾病
坐骨神经盆腔出口狭窄症	疾病
前列癃闭通胶囊	药物
先天性肠闭锁与狭窄	疾病
山绿茶降压胶囊	药物
盐酸克林霉素注射液	药物
阴囊癌	疾病
伤科接骨片	药物
复方胰酶片	药物
脊神经根受损	症状
螺内酯片	药物
保胎灵片	药物
红细胞膜磷脂	NoneType
羧甲基纤维素钠颗粒	药物
多突腐霉	细菌
上皮样血管内皮细胞瘤	疾病
溴米因	药物
没食子酸锑钠	药物
维B1乳酸钙片	药物
妊娠合并心脏病	疾病
婴儿健脾口服液	药物
药物依赖	症状
结节性血管炎	疾病
上腹弥漫性压痛	症状
甲磺酸多沙唑嗪	药物
复方益康唑氧化锌撒粉	药物
乳糜尿	NoneType
祛痰平喘片	药物
复方石菖蒲碱式硝酸铋片	药物
清金理嗽丸	药物
降脂通络软胶囊	药物
原发性血小板增多症	疾病
通痹片	药物
胸椎	NoneType
盐酸纳洛酮注射液	药物
比卡鲁胺胶囊	药物
股动脉损伤	疾病
亚硫酸氢钠甲萘醌注射液	药物
肾舒颗粒	药物
八珍补汁	药物
短杆菌肽	药物
大量皮肤脱屑	症状
乳增宁片	药物
珍珠层粉胶囊	药物
小儿先天性红细胞生成异常性贫血	疾病
足底和足背浮肿	症状
上巩膜静脉压升高所致青光眼	疾病
解热消炎胶囊	药物
脑脊液漏	NoneType
足内翻	症状
醋酸甲地孕酮片	药物
良性淋巴上皮病	疾病
手足皲裂	疾病
重组(CHO细胞)乙型肝炎疫苗	NoneType
鸢都寒痹液	药物
林旦	药物
治感佳片	药物
雷沙吉兰	药物
磷酸丙吡胺片	药物
中度或轻度头痛	症状
含钙凝血活酶	NoneType
明珠口服液	药物
复方维生素注射液	药物
肝源性水肿	症状
霍奇金病	疾病
丙硫氧嘧啶肠溶片	药物
金锁固精丸	药物
红棉散	药物
开放性气胸	疾病
傻笑	症状
结肠宁	药物
山海丹片	药物
腰椎椎管狭窄症	疾病
氢化可的松新霉素滴耳液	药物
白带丸	药物
龟蛇酒	药物
石岐外感茶	药物
臭汗恐惧症	疾病
注射用盐酸甲氯芬酯	药物
反三碘甲腺原氨酸放免药盒	药物
一水乳梨醇	药物
强直性肌营养不良症	疾病
牙隐裂	疾病
厌氧菌感染	疾病
氯沙坦钾氢氯噻嗪片	药物
人参口服液	药物
小儿郎格罕细胞性组织细胞增生症	疾病
元和正胃片	药物
二维鱼肝油凝胶	药物
康莱特软胶囊	药物
下丘脑疾病	疾病
复方磺胺对甲氧嘧啶片	药物
餐后血糖过低	症状
小儿感冒退热糖浆	药物
金莲花软胶囊	药物
祖师麻风湿膏	药物
更昔洛韦注射液	药物
鞣酸苦参碱	药物
老年人蛛网膜下腔出血	疾病
烧伤后口渴	症状
肛肠病	疾病
盐酸特比萘芬凝胶	药物
楼莲胶囊	药物
肠麻痹软瘫	症状
跌打损伤丸	药物
复方金连颗粒	药物
新生儿呕血和便血	疾病
兔唇	NoneType
动脉瘤性骨囊肿	疾病
外伤性硬脑膜下积液	疾病
九味羌活丸	药物
右侧束支传导阻滞	NoneType
林可霉素维B6乳膏	药物
L半胱氨酸	NoneType
肝素钙	药物
损伤性休克	疾病
甲亢	疾病
遗传性运动失调性多发性神经炎	疾病
乙肝解毒丸	药物
氢溴酸樟柳碱注射液	药物
口粘腻	症状
蜀柏毒蛾核多角体病毒	NoneType
利多卡因氯己定气雾剂	药物
α1-抗胰蛋白酶缺乏症	疾病
青春危险期	症状
抗磷脂综合征	疾病
硫酸新霉素软膏	药物
二十五味珍珠丸	药物
胎热	NoneType
益心酮片	药物
心可舒胶囊	药物
醋洋地黄毒苷	药物
硬下疳	症状
昏睡	症状
阿胶当归颗粒	药物
梭菌	NoneType
军刀综合征	疾病
乙型肝炎e抗原	检查科目
湿性体质	症状
三鞭参茸固本丸	药物
复方维生素B2片	药物
氟氧头孢	药物
盐酸环仑特罗片	药物
盐酸阿扑吗啡舌下片	药物
先天性巨结肠	疾病
心脑清软胶囊	药物
托瑞司他	药物
金菊五花茶冲剂	药物
鼻端形态不佳	症状
楂曲平胃合剂	药物
获得性肥胖	症状
血浆蛋白检测试剂B因子抗血清	NoneType
心包积液检查	检查科目
混合血管瘤	疾病
泊利噻嗪	药物
小儿烟酸缺乏病	疾病
垂阴茶糖浆	药物
人绒毛膜促性腺激素诊断试剂(胶体金法)	NoneType
腹肌肌肉抽搐	症状
双下肢可凹陷性水肿	症状
甲酚皂溶液	药物
尿醛固酮	药物
成骨不全	疾病
尿胆红素阴性	症状
吸气困难	症状
复合磷酸氢钾	药物
黄韧带肥厚	症状
阴缩	疾病
产后便血	症状
炎琥宁氯化钠注射液	药物
颠茄片	药物
烯丙吗啡	药物
额外牙	疾病
五妙水仙膏	药物
小儿铁粒幼红细胞性贫血	疾病
清肺抑火膏	药物
脊髓血管畸形	疾病
通便灵胶囊	药物
肾炎平颗粒	药物
咽喉疼痛	症状
四肢畸形	症状
额头皱纹突然增加	症状
桑龙利肝颗粒	药物
先天性肌缺如	疾病
小儿爱德华兹综合征	疾病
梅毒甲苯胺红不加热血清试验诊断试剂盒(TRUST)	药物
足菌肿	疾病
牙缝增宽	症状
自发性骨折	症状
肌苷	药物
痉挛性咳嗽	症状
抗精子抗体	检查科目
肋骨骨髓炎	疾病
柯萨奇病毒	NoneType
胰岛素抵抗与代谢综合征	疾病
唾液腺肿大	症状
人参补丸	药物
丹参益心胶囊	药物
血清丙氨酸氨基转移同工酶	检查科目
小儿常染色体隐性小脑性共济失调	疾病
肤康搽剂	药物
出血性梗死	症状
注射用加替沙星	药物
嗳气	NoneType
无精症	疾病
组氨酸	NoneType
红细胞乙酰胆碱脂酶	检查科目
颠茄磺苄啶片	药物
舒洛芬	药物
网球肘	症状
阴虚胃痛颗粒	药物
河豚毒素中毒	疾病
代谢性低钾	症状
粘虫痘病毒	NoneType
精氨酸阿司匹林片	药物
中上腹痛	症状
醋柳黄酮	药物
鼻屎多	NoneType
培氟沙星	药物
耳廓擦伤	症状
海蛇痹宁胶囊	药物
增力再生丸	药物
益脉康胶囊	药物
豹骨追风膏	药物
原发性硬化性胆管炎	疾病
牛黄清脑丸	药物
百咳宁片	药物
头皮不规则裂口	症状
一咳嗽胸口就疼	症状
先天性鼻咽部狭窄及闭锁	疾病
轮状病毒性肠炎	疾病
小儿后颅窝型脑积水综合征	疾病
药物性肝硬化	疾病
小儿动力性肠梗阻	疾病
妇月康颗粒	药物
严重情绪障碍	症状
原发性巨球蛋白血症	疾病
消炎退热冲剂	药物
左金丸	药物
盐酸异丙肾上腺素气雾剂	药物
鼻渊胶囊	药物
参芪五味子胶囊	药物
精囊增大	症状
腕骨发育不全变形及掌骨呈棒状改变	症状
健脾止泻宁颗粒	药物
大肠血管瘤	疾病
第五日综合征	疾病
遇冷后排汗增多	症状
强迫侧卧位	症状
阿米卡星滴眼液	药物
状元红药酒	NoneType
碘依可酯	药物
礞石滚痰片	药物
肺球孢子菌病	疾病
妊娠呕吐	疾病
Reiter综合征	疾病
双侧下腹坠痛	症状
注射用蜂毒	药物
贝尼地平	药物
环戊丙酸睾酮	药物
连续机器样杂音	症状
至宝三鞭精	NoneType
纳多洛尔	药物
强直性肌张力增高	症状
化症回生口服液	药物
无肌病性皮肌炎	疾病
珍珠灵芝片	药物
甲麻芩苷那敏片	药物
注射用胞磷胆碱钠肌苷	药物
蚕蛹补肾胶囊	药物
急性淋巴管炎	疾病
利福平眼膏	药物
输血用1号抗凝液	药物
听觉障碍	症状
甲状旁腺功能减退性心肌病	疾病
硝酸甘油贴片	药物
二母安嗽片	药物
复方磺胺脒片	药物
涎石病和下颌下腺炎	疾病
杜香油胶丸	药物
通络生骨胶囊	药物
情感麻痹	症状
Plummer-Vinson综合征	疾病
硝酸士的宁注射液	药物
地中海贫血	疾病
哌库溴铵	药物
盐酸纳洛酮	药物
皮肤呈实质性非凹陷性发硬	症状
保儿宁颗粒	药物
新鱼腥草素钠注射液	药物
活络酊	药物
慢性牙周炎	疾病
便鲜红血呈点滴状或喷射状	症状
赛洛唑啉	药物
龟头瘙痒	症状
直肠阴道瘘	疾病
湿热痹颗粒	药物
小牛血去蛋白注射液	药物
眼眶静脉性血管瘤	疾病
全血比黏度	检查科目
三尖瓣闭锁	疾病
气管梗阻	疾病
苯丙胺	药物
叶绿素铜钠片	药物
努嘴伸舌	症状
流行性乙型脑炎伴发的精神障碍	疾病
胆道运动功能障碍	疾病
骨筋丸	药物
扁蕾颗粒	药物
痴呆	NoneType
消咳颗粒	药物
发芽马铃薯中毒	疾病
抗感解毒口服液	药物
盐酸伊托必利颗粒	药物
脱阳	疾病
维磷葡钙片	药物
枸橼酸锌片	药物
口服蜡样芽孢杆菌活菌制剂	药物
先天性肌强直	疾病
骨巨细胞瘤	疾病
氨基蝶呤	药物
快感缺乏	症状
抗甲状腺过氧化物酶抗体	检查科目
药制橄榄盐	NoneType
孟鲁司特钠片	药物
腰椎滑脱	疾病
晶体异位和脱位	疾病
老年人心肌梗死	疾病
复方甘草酸单胺注射液	药物
瘢痕性脱发	疾病
幼年型类风湿病	疾病
喘息灵胶囊	药物
熊胆救心丸	药物
蜡样芽胞杆菌粉	NoneType
小儿原发性纤毛运动障碍	疾病
前十字韧带损伤	疾病
伤痛宁胶囊	药物
外踝前下方肿胀和疼痛	症状
西咪替丁口服乳	药物
肺气虚	疾病
胃液蛋白酶	NoneType
愈风宁心口服液	药物
阴囊损伤	疾病
脾阳虚	症状
藿香清胃胶囊	药物
注射用甲硫氨酸维B1	药物
血清总蛋白	NoneType
咽角化症	疾病
儿童学习能力障碍	疾病
路易体痴呆	疾病
复方肝炎颗粒	药物
氟氢可的松	药物
康氏牛黄解毒丸	药物
黄芩片	药物
大补药酒	药物
藻酸双脂钠片	药物
耳痒	症状
胃平滑肌瘤	疾病
氟比洛芬酯注射液	药物
太阳穴胀痛	症状
非器质性性欲减退	疾病
行走后小腿肌肉痉挛	症状
磷酸氯喹注射液	药物
菊明降压片	药物
保和口服液	药物
月骨脱位及月骨周围脱位	疾病
壮西六味散	药物
维生素D缺乏	NoneType
头孢泊肟酯片	药物
十滴水胶丸	药物
龙血竭胶囊	药物
先天性远端尺桡关节半脱位	疾病
老年人糖尿病乳酸性中毒	疾病
克霉唑药膜	药物
水痘肺炎	疾病
对氨基水杨酸异烟肼	药物
妇炎康片	药物
高腭弓	症状
益多酯	药物
益母康颗粒	药物
解肌清肺丸	药物
变应性皮肤结节性血管炎	疾病
副肿瘤性脊髓病	疾病
胃肿瘤	疾病
消渴降糖片	药物
冻干风疹活菌苗	NoneType
布库洛尔	药物
早产儿贫血	疾病
肾炎舒胶囊	药物
凉血十味散	药物
腰部缓慢增大的软肿块	症状
肠梨形鞭毛虫病	疾病
吡拉西坦葡萄糖注射液	药物
胫骨结节骨软骨病	疾病
青叶胆提取物片	药物
伏立康唑	药物
慢性盆腔炎	疾病
东乐膏	药物
链霉菌	病毒
意向倒错	症状
双氢奎尼丁	药物
鱼石脂颠茄软膏	药物
肿痛气雾剂	药物
新生儿反应低下	NoneType
三氯化铝	药物
柠檬色痰	症状
盐酸雷尼替丁咀嚼片	药物
脑脊液比重	NoneType
汞溴红	药物
胸壁浸润	症状
白甲	症状
内向性思维	NoneType
视神经脊髓炎	疾病
急性会厌炎	疾病
颠茄	药物
瑞士乳杆菌	NoneType
神经元特异性烯醇化酶酶免定量测定试剂盒	药物
顺气补心十一味丸	药物
注射用氢溴酸右美沙芬	药物
复方三七补血片	药物
乳酸氟罗沙星	药物
酚酞片	药物
腹部肿块	疾病
盐酸青藤碱肠溶片	药物
蟾酥丸	药物
华蟾素片	药物
疼痛性脂肪疝	疾病
非01霍乱弧菌肠炎	疾病
手足发抖	症状
丹芪偏瘫胶囊	药物
维生素D滴剂	药物
β-氨基酸尿	症状
舌乳头增生	NoneType
健脾凝胶	药物
软化斑	疾病
养血饮颗粒	药物
肾前性肾功能衰竭	疾病
清肝片	药物
球红霉素	药物
甲氨蝶呤	NoneType
脐部脐肠系膜管息肉	NoneType
心房对心室收缩的辅助泵作用丧失	症状
复方庆大霉素普鲁卡因胶囊	药物
降脂灵胶囊	药物
五维赖氨酸口服溶液	药物
角栓	症状
葡萄球菌食物中毒	疾病
中性蛋白酶	NoneType
压迫性视神经病变	疾病
小儿慢性胃炎	疾病
黄曲霉	NoneType
慢性心力衰竭	疾病
血康口服液	药物
继发性化脓性腹膜炎	疾病
维生素C氯化钠注射液	药物
神经症性抑郁	症状
富马酸酮替芬片	药物
面、头、颈、肩发作性剧痛	NoneType
去羟肌苷颗粒	药物
养血当归软胶囊	药物
胆囊胆固醇沉着症	疾病
茎突综合征	疾病
尿路软斑症	疾病
柏子仁丸	药物
冻干蜂王浆软胶囊	药物
复方碘试验	药物
惧站立，喜依托	NoneType
参鹿茶	药物
林旦乳膏	药物
麝香酮	药物
腺病毒肺炎	疾病
消咳片	药物
僵蛹片	药物
清燥润肺合剂	药物
青乳消颗粒	药物
小儿尿崩症	疾病
硫酸美芬丁胺注射液	药物
止痛消炎软膏	药物
复方岩白菜素	药物
伤可贴	NoneType
鼻尖上翘呈马鞍状	症状
海龙胶	药物
替克洛占	药物
甲磺酸二氢麦角碱注射液	药物
马来酸非尼拉敏	NoneType
匹多莫德颗粒剂	药物
复方珍珠暗疮片	药物
破伤风人免疫球蛋白	药物
驴胶补血颗粒	药物
复方太子参颗粒	药物
空蝶鞍综合征	疾病
小儿波-杰综合征	疾病
流行性感冒病毒裂解疫苗	药物
嘎日迪五味丸	药物
盐酸曲马多分散片	药物
尿胆汁酸	NoneType
氨酪酸氯化钠注射液	药物
肱骨远端全骨骺分离	疾病
不明原因发热	症状
胆结石	NoneType
特拉唑嗪	药物
食指感觉消失	症状
盐酸伐昔洛韦缓释片	药物
肱骨大结节骨折	疾病
茶碱缓释片	药物
羟甲烯龙	药物
腰椎膨出	症状
克银丸	药物
土霉素片	药物
胞生痰核	疾病
日舒安湿巾	药物
噻托溴铵	药物
臀部酸痛	NoneType
大腿刺痛	症状
磷32	NoneType
嗜酸性粒细胞性膀胱炎	疾病
外用应急软膏	药物
咳露口服液	药物
肾皮质化脓性感染	疾病
丁四硝酯	药物
金牛眼药	药物
胍乙啶	药物
尿道综合征	疾病
甲状腺微粒体抗体放射免疫分析药盒	药物
消食健儿冲剂	药物
主动脉肠道瘘	疾病
乳溢-闭经综合征	疾病
蕲蛇酶时间	NoneType
心脑舒通胶囊	药物
肠蠕动减少	症状
过敏性紫癜肾炎	疾病
神经内分泌肿瘤皮肤转移	疾病
前房色素沉积	症状
硫酸小诺霉素片	药物
疼痛性股青肿	症状
电解质紊乱	疾病
妥拉唑啉	药物
肺实变	症状
细辛脑	药物
益气养血口服液	药物
壮骨木瓜丸	药物
马布特罗	药物
老年人乳头肌功能不全和断裂	疾病
金嗓利咽丸	药物
弦脉	症状
血栓外痔	症状
复方氨酚烷胺分散片	药物
那拉曲坦	药物
肤色赤红	症状
外阴隆凸性皮肤纤维肉瘤	疾病
僵鉧	疾病
莲胆消炎胶囊	药物
硫酸链霉素	NoneType
内伤发热	疾病
间质性肺炎	疾病
髋关节后脱位	疾病
念珠状红苔藓	疾病
注射用还原型谷胱甘肽	药物
小儿α-地中海贫血	NoneType
小儿增食颗粒	药物
指甲尖有缺痕	症状
他达那非	药物
高血压病伴发的精神障碍	疾病
盐酸纳洛酮片	药物
小腹刺痛	症状
钻山风糖浆	药物
急性闭角性青光眼	疾病
依曲替酯	药物
产后劳伤	疾病
痧气丸	药物
氟哌啶醇	NoneType
疲劳性骨折	疾病
结缔组织痣	疾病
视网膜震荡	症状
麻仁胶囊	药物
藿香正气片	药物
钩回发作	症状
头昏想睡觉	症状
残胃平滑肌肉瘤	疾病
小儿克罗恩病	疾病
复方吉祥草含片	药物
注射用硫酸长春新碱	药物
甲流	NoneType
妇炎泰颗粒	药物
耳聋片	药物
十三味疏肝胶囊	药物
七味都气丸	药物
替加色罗	药物
胸部紧迫或束带感	NoneType
喹那普利	药物
连翘败毒膏	药物
晕可平颗粒	药物
小儿传染性单核细胞增多症	疾病
弥漫型间皮瘤	疾病
阿司匹林维C肠溶片	药物
脑血康口服液	药物
颈椎半椎体畸形	疾病
Pick病和额颞痴呆	疾病
门冬胰岛素	药物
甲磺酸培氟沙星	药物
睡眠时间倒错	症状
鼻咽癌的远处转移	症状
环状外阴炎	疾病
萝芙木片	药物
胃粘膜增粗	症状
益气补肾胶囊	药物
二十味沉香丸	药物
乙肝养阴活血颗粒	药物
婴儿闷热综合症	疾病
僵人综合征	疾病
盐酸安非他酮片	药物
婴儿肉毒中毒综合征	疾病
肾小球肾炎	疾病
鹿胎颗粒	药物
假结核结节	症状
寒战	症状
肌肉压痛	症状
氨基酸型肠内营养剂	药物
利培酮片	药物
依马打正红花油	药物
十五味黑药丸	药物
锁骨下动脉盗血综合征	疾病
颅骨连续性中断	症状
止咳丸	药物
急性胃肠炎	疾病
蚕蛾公补合剂	药物
二妙丸	药物
平喘益气颗粒	药物
盐酸多沙普仑	药物
复方酮酸片	药物
水钠的蓄积	症状
震灵丸	药物
癌细胞逆行播散	药物
喉气管瘢痕性狭窄	疾病
中毒性眩晕	疾病
苯佐那酯	药物
痹祺胶囊	药物
阿苯达唑口服乳剂	药物
尿中组织胺排泄增加	症状
右美沙芬缓释混悬液	药物
心包积液	疾病
儿感退热宁颗粒	药物
膈肌缺损	症状
卡莫司汀注射液	药物
天麻丸	药物
止痛紫金丸	药物
疤痕处破损后出现溃疡	症状
胃舒止痛片	药物
复合乳酸菌	药物
白葡萄球菌片	药物
包涵体肌炎	疾病
绿菇	NoneType
醋酸倍他米松	NoneType
肌苷颗粒	药物
血清尿素	检查科目
地黄叶总苷	NoneType
十二指肠白点综合征	疾病
瘰疬	疾病
妊娠合并癫痫	疾病
柴胡舒肝丸	药物
肾皮质脓肿	疾病
拇趾与二趾趾间距大	症状
肾动脉血栓形成和栓塞	疾病
注射用尼麦角林	药物
维U颠茄铝镁片	药物
度米芬喉片	药物
可的松	NoneType
硫酸软骨素A	药物
乙氧苯柳胺软膏	药物
重组人红细胞生成素注射液	药物
多汗症	疾病
产后胸部下垂	症状
风湿伤痛膏	药物
七叶莲片	药物
萘普生钠缓释片	药物
软产道裂伤	NoneType
大川芎片	药物
阿替洛尔片	药物
加味逍遥胶囊	药物
慢性疾病的贫血	疾病
呋喃唑酮片	药物
罗钠卡比	药物
慢性胆管炎	疾病
舒胆通	药物
烧伤止痛膏	药物
打哈欠	症状
产后抑郁症	疾病
三仁合剂	药物
七厘胶囊	药物
乙型脑炎病毒抗体	检查科目
硅碳银片	药物
恙虫病性肺炎	疾病
脑心安胶囊	药物
嗜酸性粒细胞数	NoneType
妊娠期甲状腺功能亢进	疾病
尿中雌激素增高	症状
芽生菌病	疾病
风寒砂熨剂	药物
缓症链球菌	NoneType
大肠埃希氏杆菌	药物
格列齐特片	药物
乳酸环丙沙星阴道泡腾片	药物
注射用对氨基水杨酸钠	药物
复方利血平	药物
瘙痒症	疾病
脑结核瘤	疾病
骨气臌	症状
十二指肠炎	疾病
老年咳喘片	药物
指甲宽而短(宽大于长)	症状
糖尿病坏疽	疾病
尼古丁	药物
痿病	疾病
心血宁片	药物
贝伐单抗	药物
川参通注射液	药物
背部长痘	症状
尿钠排出量极低	症状
气血双补丸	药物
酒精性震颤	症状
马来酸噻吗洛尔滴眼液	药物
急性呼吸衰竭	疾病
调经至宝丸	药物
新生化颗粒	药物
血管畸形	症状
向心性肥胖	症状
疣状肢端角化病	疾病
王氏保赤丸	药物
臭汗	NoneType
消洗灵	药物
冻干水痘减毒活疫苗	药物
胸壁软组织畸形	疾病
运动后全身酸痛	症状
百咳静颗粒	药物
金果饮咽喉片	药物
局部皮肤变紧	症状
吸气时上气道陷闭	症状
背痈	疾病
小儿利湿止泻颗粒	药物
联磺甲氧苄啶胶囊	药物
牛黄清感胶囊	药物
头昏眼花	症状
氟米龙	NoneType
T波低平或倒置	症状
复方氯丙那林鱼腥草素钠片	药物
四氢唑啉	药物
陆氏润字丸	药物
盐酸地尔硫卓缓释片	药物
指甲嵌入肉	症状
聚乙二醇4000	药物
眼睑外翻	NoneType
注射用葡萄糖酸依诺沙星	药物
子宫内膜息肉	疾病
外伤性脑积水	疾病
脑蛋白水解物口服液	药物
胃灵颗粒	药物
痔核	疾病
Korsakov综合征	疾病
醋酸氯己定栓	药物
脂肪营养不良	疾病
咽部及颈部食管闭合性损伤	疾病
心房心肌梗死	疾病
冻干葡萄球菌A蛋白纯品	NoneType
依替米星	药物
女贞子糖浆	药物
播散性黄瘤伴尿崩症	疾病
玫芦消痤膏	药物
流行性出血热病毒抗体	检查科目
变态反应性鼻炎	疾病
咳痰清糖浆	药物
吸入性肺炎	疾病
四季菜颗粒	药物
头癣	疾病
双羟萘酸奥克太尔	药物
酚麻美敏片	药物
注射用阿莫西林钠克拉维酸钾	药物
红古豆醇酯栓	NoneType
至宝三鞭酒	NoneType
肉芽肿性唇炎	疾病
氨酚伪麻咀嚼片	药物
舒张性心力衰竭	疾病
诺氟沙星锌乳膏	药物
迫害妄想	症状
关节游走性疼痛，肿胀	症状
板蓝根泡腾片	药物
睾丸畸形	疾病
产科休克	疾病
空鞍综合征	疾病
拔毒生肌散	药物
山花晶	药物
少林风湿跌打膏	药物
利斯特菌病	疾病
肺隔离症	疾病
皮疹呈瘀点	症状
硫糖铝混悬液	药物
视网膜Roth斑	症状
前置胎盘	疾病
吐血痰	症状
精液细胞	检查科目
血清酶学改变	症状
八宝玉枢丸	药物
颈型颈椎病	疾病
平阳霉素	药物
睾丸胀痛	症状
急性乳突炎	疾病
癣药膏	药物
拔牙后出血不止	症状
更昔洛韦	药物
参苏丸	药物
酒精中毒性幻觉症	疾病
非寄生虫性肝囊肿	疾病
小儿毛细支气管炎	疾病
非甾体类抗炎药物性肾病	疾病
先天性二尖瓣畸形	疾病
血瘀体质	症状
试管凝集试验	检查科目
安钠咖片	药物
碳酸钙颗粒	药物
痉挛性便秘	症状
美雄酮	药物
归脾片	药物
疮炎灵软膏	药物
肛门坠胀	NoneType
先天性非溶血性黄疸	疾病
胸腺小细胞癌	疾病
尿钾	检查科目
眼球破裂伤	疾病
盐酸羟苄唑滴眼液	药物
更衣胶囊	药物
硫酸沙丁胺醇	NoneType
口唇周围有炎性鳞状皮肤	NoneType
胃憩室	疾病
金莲花口服液	药物
长城止咳喘糖浆	药物
养血饮胶囊	药物
复方已酸羟孕酮注射液	药物
胞磷胆碱钠注射液	药物
复方酮康唑乳膏	药物
血精	症状
老年人稳定型心绞痛	疾病
环扁桃酯胶囊	药物
痔疾洗液	NoneType
金银花露	药物
牛黄蛇胆川贝液	药物
低镁血症	疾病
复心片	药物
景天清肺胶囊	药物
T3T4抗体	检查科目
复方福尔可定溶液	药物
伊米苷酶	药物
千紫红胶囊	药物
强制性哭笑	症状
宫瘤宁片	药物
胰瘘	疾病
益中生血胶囊	药物
皮肤白喉	疾病
低分子量肝素钙	药物
尿亚硝酸盐	检查科目
髋关节骨关节炎	疾病
晶状体突出	症状
先天性结肠狭窄和闭锁	疾病
先天性感觉性神经病	疾病
肾精亏虚	疾病
轮状病毒	症状
羟基脲片	药物
百草枯中毒	疾病
鼻子长痘	症状
眼眶脓肿	疾病
结肠脂肪瘤	疾病
记忆受损	症状
青少年癫痫	疾病
发疱性甲虫皮炎	疾病
妇平胶囊	药物
利福霉素钠氯化钠注射液	药物
大补阴丸	药物
双眼难以忍受的奇痒	症状
先天性小肠闭锁和肠狭窄	疾病
膝、踝反射减退	NoneType
反复发作性头痛	症状
磺胺米隆	药物
索法酮	药物
骨髓巨核细胞数和分类	检查科目
藿香水	药物
雷莫司琼	药物
益气养元颗粒	药物
安坤胶囊	药物
手握物无力	症状
肺动脉楔压（PCWP）降低	NoneType
丹参滴注液	药物
肌腱炎	疾病
血清乙酰乙酸	检查科目
葡萄膜炎	疾病
注射用奈达铂	药物
阿伐斯汀	药物
盐酸罂粟碱氯化钠注射液	药物
胆心综合征	疾病
气道变窄	症状
松石散	药物
骨科	医学专科
白带增多	症状
汗液电解质检查	检查科目
松节油皮炎	疾病
骨盆直肠脓肿	疾病
牙移位	NoneType
不规则热	症状
明目蒺藜丸	药物
肝脏血管瘤	疾病
龙眼莲子羹	NoneType
面部疖痈	疾病
神经性尿频	症状
景天虫草含片	药物
氨甲苯酸氯化钠注射液	药物
美吡拉敏	药物
脑源性晕厥	疾病
浆细胞性唇炎	疾病
肛裂三联征	症状
淋病性关节炎	疾病
成人痒疹	疾病
麝香追风止痛膏	药物
甘露六烟酯片	药物
尼群地平片	药物
桂附地黄丸	药物
单侧鼻腔阻塞	症状
颞骨和下颔骨关节异常	疾病
十五味赛尔斗丸	药物
干燥性角结膜炎	疾病
窦性组织细胞增生伴巨大淋巴结病	疾病
寒滞肝脉证	疾病
盐酸左氧氟沙星葡萄糖注射液	药物
定坤丹水蜜丸	药物
裂谷热	疾病
注射用盐酸地尔硫卓	药物
心悸伴乏力、面色苍白	NoneType
胸膜肥厚	症状
急性化脓性鼻窦炎	疾病
肝静脉病变	症状
循环血浆量	NoneType
肺泡通气低下综合征	疾病
复方雪胆呋喃唑酮胶囊	药物
血管畸形引起的吞咽困难	疾病
降酶灵片	药物
葶苈降血脂胶囊	药物
盐酸特比萘芬喷雾剂	药物
消积肥儿丸	药物
大肠杆菌	NoneType
清宁丸	药物
脉舒胶囊	药物
冬季瘙痒症	疾病
止嗽合剂	药物
安尔眠颗粒	药物
西地磷酸苯丙哌林泡腾片	药物
腹主动脉缩窄	疾病
依普黄酮片	药物
果糖二磷酸钙片	药物
Gardner综合征	疾病
皮肤白血病	疾病
盐酸氮芥酊	药物
治伤消瘀丸	药物
上行性皮肤麻木	症状
醋氯芬酸肠溶胶囊	药物
精囊缩小	症状
维C银翘片	药物
盐酸多塞平片	药物
乳糜微粒	NoneType
单侧头痛	症状
臀中肌麻痹步态	症状
口服补液盐	药物
舒林酸片	药物
交感性眼炎	疾病
固定性斜视	疾病
纳豆芽孢杆菌	NoneType
肝络欣丸	药物
膀胱膨出	疾病
制金柑丸	药物
盐酸维拉帕米注射液	药物
外阴鳞状上皮疣状增生	症状
襄樊大头菜	NoneType
复方胃蛋白酶颗粒	药物
肝被膜血肿破裂	症状
胞磷胆碱钠胶囊	药物
治疗用A型肉毒毒素	药物
隔山消积颗粒	药物
银黄颗粒	药物
色斑	NoneType
多灶性脉络膜炎伴全葡萄膜炎	疾病
急性化脓性脊髓炎	疾病
败血症肾损害	疾病
健脾降脂冲剂	药物
混浊尿	症状
弥漫性系膜硬化	NoneType
双金胃肠胶囊	药物
脑膜炎奈瑟菌肺炎	疾病
心慌气短	NoneType
伊维菌素片	药物
卡芦莫南	药物
西咪替丁氯化钠注射液	药物
眼前异常闪光，增加的黑点	症状
下腰椎不稳症	疾病
黄升丹	NoneType
神经纤维瘤	疾病
气管前间隙感染	疾病
小儿健胃糖浆	药物
消疲灵颗粒	药物
石淋通冲剂	药物
声音嘶哑	症状
色素绒毛结节性滑膜炎	疾病
关节镇痛巴布膏	药物
芪棱片	药物
面神经瘤	疾病
三氟哌多	药物
肱骨髁上骨折	疾病
生长期脱发	疾病
保元丸	药物
苄丝肼	药物
围术期伴发的精神障碍	疾病
金钱白花蛇药酒	药物
小儿颅内肿瘤	疾病
倍他米松软膏	药物
蟾蜍分枝杆菌	NoneType
乳酸亚铁片	药物
二母安嗽糖浆	药物
吲哚美辛控释胶囊	药物
二乙酰氨乙酸乙二胺	药物
小儿大脑半球胶质瘤	疾病
慢性肝炎	疾病
白细胞增多	症状
钠钾葡萄糖注射液	药物
通络骨质宁膏	药物
乌鸡白凤丸水蜜丸	药物
溃疡性结肠炎性关节炎	疾病
心音微弱	症状
颈部脊髓损伤	疾病
先天性长结肠	疾病
寂静腹	症状
虹膜黑色素瘤	疾病
呋咱甲氢龙	药物
盆腔结缔组织炎	疾病
朊毒体病	疾病
勒马回胶囊	药物
脉平片	药物
注射用双氯芬酸钠盐酸利多卡因	药物
祛风骨痛巴布膏	药物
单胺氧化酶	检查科目
直腿伸踝试验阳性	NoneType
维生素EC颗粒	药物
保产无忧丸	药物
快胃片	药物
多巴胺	药物
依赖公式化	症状
胎儿单臂先露	症状
丙种免疫球蛋白	药物
寡养单胞菌	NoneType
曲霉病	疾病
直肠损伤	疾病
田基黄注射液	药物
埃布斯坦综合征	疾病
先天性小耳畸形	NoneType
复方苯佐卡因软膏	药物
丁型肝炎抗原	检查科目
继发性纵隔感染	疾病
身体“福态”	症状
生脉饮(人参方)	NoneType
万金香气雾剂	药物
甘草酸二铵注射液	药物
贪食	症状
冻干人凝血酶原复合物	药物
药物相关性免疫性溶血性贫血	疾病
依降钙素	药物
镇静药中毒	疾病
慢性附睾炎	疾病
进行性肝缩小	症状
鼻前颅底肿瘤	疾病
复方氨基酸注射液(9AA)	药物
复方乌槟颗粒	药物
胸部沉重感	症状
肚痛丸	药物
花红颗粒	药物
呼吸肌疲劳症	疾病
骨转移	症状
气管肿瘤	疾病
卡地腐霉	细菌
小儿止嗽金丹	NoneType
角膜色膜环	症状
外伤性脑脓肿	疾病
胆胀	疾病
尼扎替丁	药物
尿囊素铝片	药物
脐周围褪色	症状
鼠疫	疾病
先天性乳糖酶缺乏	症状
白细胞分类计数	检查科目
土霉素眼膏	药物
尼群地平贴片	药物
骨骺提前闭合	症状
氧氟沙星缓释片	药物
普卢利沙星胶囊	药物
心源性休克	疾病
湛江蛇药	药物
双氯芬酸钠搽剂	药物
青鹏膏剂	药物
异性蛋白反应	症状
乳糖酸克拉霉素	药物
感冒灵胶囊	药物
乳腺纤维腺瘤	疾病
安脑片	药物
贞蓉丹合剂	药物
狼疮样综合征	疾病
美拉胂醇	药物
色素性紫癜性苔藓样皮病	疾病
胼胝体进行性变性	疾病
西帕依麦孜彼子胶囊	药物
雷公藤总萜片	药物
盐酸肼屈嗪片	药物
克林霉素磷酸酯栓	药物
喷托维林愈创甘油醚片	药物
注射用盐酸多西环素	药物
核黄素四丁酸酯	药物
大孢子链霉菌	NoneType
厄洛替尼	药物
股骨转子间骨折	疾病
褐黄病性关节炎	疾病
卡泊三醇	药物
奥美拉唑镁肠溶片	药物
妇宁康胶囊	药物
生尔发糖浆	药物
心尖搏动弥散	药物
肢萎	NoneType
韦格纳肉芽肿性巩膜炎	疾病
氨茶碱暴马子胶囊	药物
狭窄骨盆	症状
定喘止嗽丸	药物
小儿豉翘清热颗粒	药物
溴苄胺	药物
前列安通片	药物
同向性偏盲	症状
复方益母颗粒	药物
外源性过敏性肺泡炎	疾病
器械性食管损伤	疾病
公鸡步态	症状
子宫增大明显（子宫增大超过胎龄）	NoneType
中毒性坏死性表皮松解型药疹	NoneType
支气管树受压	症状
单房性骨囊肿	疾病
多发性肌炎和皮肌炎伴发的精神障碍	疾病
孕康颗粒	药物
珍合灵片	药物
澳泰乐胶囊	药物
立毛反射减弱	症状
口腔颌面部后天畸形和缺损	疾病
精氨酸乙酰水杨酸	药物
龙骨颈椎胶囊	药物
三维葡磷钙咀嚼片	药物
肾部积水现象	症状
慢性颈部软组织损伤	疾病
注射用细胞色素C	药物
Fuchs角膜内皮营养不良	疾病
七味诃子散	药物
发射学	NoneType
思考困难感	症状
野苏胶囊	药物
复方羚角降压片	药物
淀粉样变性	疾病
参茸三鞭丸	药物
舌苔厚腻	症状
结肠内形成坚硬的粪石	症状
蛛网膜炎	疾病
婴幼儿外阴疼痛	症状
肾舒冲剂	药物
失眠症	疾病
奥沙西泮	药物
阿卡波糖	药物
痢特敏胶囊	药物
氯贝胆碱	药物
雷公藤双层片	药物
排毒降脂胶囊	药物
保济口服液	药物
舒必利注射液	药物
肱骨头骨折	疾病
胞痹	疾病
维生素B6软膏	药物
浓甲硝唑含漱液	药物
安吖啶	药物
尿谷草转移酶	检查科目
霍纳综合征	疾病
安嗽化痰丸	药物
头孢羟氢苄颗粒	药物
肌强直性肌病	疾病
九合维生素丸	药物
清降丸	药物
泻肺定喘片	药物
老年人血栓性疾病	疾病
肾肿瘤	疾病
自发性脑室内出血	疾病
子宫穿孔	症状
枯草热	疾病
淋巴瘤	疾病
拳状手畸形	症状
甘磷酰芥片	药物
盐酸阿奇霉素	药物
黄香颗粒	药物
匹多莫德颗粒	药物
涎腺病毒病	疾病
卡非西林	药物
巨大血小板病	疾病
老年人脑血栓形成	疾病
劳累后感觉胸闷	症状
头孢匹罗	药物
枸橼酸铁铵	NoneType
下丘脑多汗症	疾病
利儿康口服液	药物
散寒感冒片	药物
洗消净	NoneType
小儿肠炎	疾病
泌淋胶囊	药物
复方氨基酸注射液	药物
氨酚伪麻片	药物
经期小腹坠痛	症状
小儿维生素B2缺乏病	疾病
肝苏颗粒	药物
复方扶芳藤胶囊	药物
风寒咳嗽丸	药物
山楂麦曲颗粒	药物
毛孔角化过度	症状
复方庚炔诺酮	药物
金莲花颗粒	药物
羌月乳膏	药物
关节腔液检查	检查科目
心舒宝片	药物
窥阴癖	疾病
退热清咽颗粒	药物
盐酸美他环素胶囊	药物
阿尔茨海默病性痴呆	疾病
枸橼酸莫沙必利胶囊	药物
巴斯德菌肺炎	疾病
龙胆泻肝软胶囊	药物
妊娠合并再生障碍性贫血	疾病
九龙胃药胶囊	药物
头孢氨苄缓释胶囊	药物
蛋白质能量营养不良	疾病
慢性溃疡性非肉芽肿性空肠回肠炎	疾病
注射用硫酸庆大霉素	药物
羟乙基淀粉130/04氯化钠注射液	药物
复方利血平氨苯蝶啶片	药物
局限性胸膜间皮瘤	疾病
节育手术并发症	疾病
继发性腹膜炎	疾病
藏青果颗粒	药物
双胎静脉吻合	症状
复方喜树碱贴片	药物
急性细菌性前列腺炎	疾病
甲硝唑阴道栓	NoneType
唇病	疾病
盐酸异可利定片	药物
齐拉西酮	药物
连翘败毒片	药物
肝肿瘤	疾病
富马酸依美斯汀	药物
雪上一枝蒿总碱注射液	药物
鼻前庭部发痒	症状
破伤风抗体诊断试剂(血凝法)	药物
清痹通络药酒	NoneType
髌骨骨折	疾病
脱屑性间质肺炎	疾病
六合定中丸	药物
风湿酒	NoneType
不排卵	症状
夜间肩痛	症状
阴道分泌物细胞学检查	检查科目
益气六君丸	药物
淋球菌感染	疾病
母乳性黄疸	疾病
乳疾灵胶囊	药物
耳垂过大	症状
口唇刺痛	症状
哮喘片	药物
两肺毛玻璃样粟粒样或结节样改变	症状
华容口服液	药物
脉络膜缺血	疾病
浅眠	症状
益气养血合剂	药物
二十五味獐牙菜丸	药物
氯霉素眼膏	药物
当归浸膏片	药物
异卡波肼	药物
踝部凹陷性水肿	症状
宝儿康糖浆	药物
皮肤搔痒	症状
药物或化学物质所致的色素沉着	疾病
粪胆红素	NoneType
丙帕他莫	药物
异戊巴比妥	药物
维生素A软胶囊	药物
氟芬那酸胶囊	药物
阿米巴性阴道炎	疾病
副神经损伤	疾病
自然流产	疾病
呋喃硫胺片	药物
毛囊漏斗肿瘤	疾病
肺栓塞	疾病
动脉硬化性闭塞症	疾病
溢泪症	疾病
右旋糖酐20氯化钠注射液	药物
小儿支气管哮喘	疾病
注射用硫酸头孢噻利	药物
牛黄降压胶囊	药物
老年人心房纤颤	疾病
阴茎癌	疾病
劳拉西泮	药物
鼻血止颗粒	药物
甲磺酸酚妥拉明	药物
虫草川贝止咳膏	药物
青春期甲亢	症状
肉瘤皮肤转移	疾病
肌肉萎缩	NoneType
结节性多动脉炎伴发的葡萄膜炎	疾病
一氧化碳中毒	疾病
益肝灵胶囊	药物
粪柱变形变细	症状
地磁	NoneType
清开灵分散片	药物
板层状鱼鳞病	疾病
黄藤素分散片	药物
眼底樱桃红斑	症状
跟骨骨刺综合征	疾病
嗜酸细胞增多性非变态反应性鼻炎	疾病
肺心片	药物
肾盂肾炎	疾病
润肺止咳胶囊	药物
红香止痛酊	药物
乳腺退化不全	症状
小肠重复畸形	疾病
超雄	症状
姜酊	药物
多潘立酮分散片	药物
同仁大活络丸	药物
小儿周期性正常血钾性麻痹	疾病
格帕沙星	药物
诃子五味胶囊	药物
巯嘌呤片	药物
纤维肉瘤	疾病
注射用盐酸氯胺酮	药物
耳道异物	症状
乱飞虫	NoneType
矫正型大动脉错位	NoneType
甘草酸二钾	NoneType
微杆菌	NoneType
皮角	疾病
肝昏迷	症状
猪脱氧胆酸片	药物
腹围增大	症状
产后手指痛	症状
助消膏	药物
复方磺胺嘧啶颗粒	药物
参茸大补膏	药物
重组甘精胰岛素注射液	药物
小儿右肺中叶综合征	疾病
口腔粘膜上白色较硬的隆起斑块	症状
眼内有异物感	症状
亚急性结节性游走性脂膜炎	疾病
脑型肺吸虫病	疾病
香连胶囊	药物
部位不定的疼痛	症状
永存动脉干	疾病
氨溴索	药物
胰多肽瘤	疾病
甘露茶	药物
刚果红试验	检查科目
周身不适	症状
眼眶寄生虫囊肿	疾病
体寒	NoneType
大叶性肺炎	疾病
风湿宁药酒	NoneType
泪液分泌过多	疾病
齐墩果酸胶囊	药物
老年人椎基底动脉供血不足	疾病
表皮内嗜中性IgA皮肤病	疾病
盐酸布比卡因注射液	药物
小儿肺炎散	药物
合成天麻素片	药物
类白血病反应	疾病
替扎尼定	药物
盐酸齐拉西酮	药物
小儿血管瘤	疾病
银黄丸	药物
股部内侧靠近阴囊处的皮疹	症状
颈软不能抬头	症状
回生第一丹	药物
痛风和高尿酸血症	疾病
依他尼酸片	药物
急性牙髓炎	疾病
圆锥角膜	疾病
中暑	NoneType
阿法骨化醇胶囊	药物
面肌强直	症状
硫必利	药物
胸腺喷丁	药物
营养代谢缺乏	症状
肺假性淋巴瘤	疾病
鞣酸软膏	药物
氨酚伪麻美芬片	药物
边缘假单胞菌	NoneType
盐酸塞利洛尔片	药物
类风湿相关核抗原(RANA)抗体	检查科目
冠状动脉栓塞	病毒
八宝丹	药物
变形菌OX19诊断菌液	NoneType
黏液表皮样癌	疾病
皮下脂肪增多	症状
乙酰丙嗪	药物
粘虫核多角体病毒	NoneType
克泻胶囊	药物
速效心痛气雾剂	药物
氨碘肽滴眼液	药物
金果榄凝胶	药物
炎热清软胶囊	药物
瑞莫必利	药物
硫酸罗通定注射液	药物
赖氨酸王浆口服液	药物
指(趾)骨梗死	症状
骨关节炎	疾病
联合瓣膜病变	疾病
盐酸赖氨酸注射液	药物
反向斜视	疾病
根瘤菌	细菌
面肌萎缩	症状
橘红胶囊	药物
小儿清肺化痰口服液	药物
儿滞灵冲剂	药物
硝苯地平控释片	药物
焦虑致胸口痛	症状
延胡索乙素	药物
急性肠系膜淋巴结炎	疾病
消炎癣湿药膏	药物
益津降糖口服液	药物
脑脊液白细胞增加	症状
去痛片	药物
盐酸羟甲唑啉喷雾剂	药物
复方鸡内金片	药物
下肢血压偏低	症状
老年人低钙血症	疾病
小儿完全性肺静脉异位连接	疾病
右旋酮洛芬氨丁三醇片	药物
高胡萝卜素血症	疾病
寒冷凝集试验	检查科目
刺五加注射液	药物
尿草酸盐	检查科目
无尿	症状
罗通定片	药物
普通古蚖	NoneType
茵白肝炎冲剂	药物
心理性性功能障碍	NoneType
精液稠	症状
止痢七味散	药物
三七总皂苷	NoneType
驱风痛片	药物
热带假丝酵母	NoneType
舍他康唑	药物
胡萝卜素血症	疾病
沙梅消渴胶囊	药物
异常子宫出血	症状
粪中结晶	NoneType
咳嗽晕厥综合征	疾病
维生素C咀嚼片	药物
不可克制的饮酒冲动	症状
大肠平滑肌肉瘤	疾病
先天性静脉畸形肢体肥大综合征	疾病
门冬酰胺片	药物
注射用磷酸盐缓冲盐水	药物
慢性自律性房性心动过速	疾病
红细胞生成性原卟啉病	疾病
下肢皮肤营养性改变	症状
生长痛	疾病
多粘菌素	药物
赖氨加压素	药物
肾脏破裂	症状
隐球菌感染	症状
皮肤血管收缩呈网状图案	症状
消炎生肌膏	药物
宫血宁胶囊	药物
睑缘呈横“S”形下垂	症状
加味白药丸	药物
红细胞还原型谷胱甘肽(GSH)及稳定试验	检查科目
小儿神经皮肤综合征	疾病
盐酸马普替林片	药物
特发性急性小管间质性肾炎	疾病
克霉唑软膏	药物
布洛芬干混悬剂	药物
颅脑损伤	疾病
愈风宁心颗粒	药物
本芴醇	NoneType
H7n7	疾病
获得性血友病	疾病
阿吡坦	药物
吞咽困难	症状
婴儿步行晚	症状
肝腺瘤	疾病
RhD血型定型试剂(单克隆抗体IgM)	药物
男子乳腺发育	疾病
嗨诺惰秋齐胶囊	药物
牙齿形态异常	NoneType
洁阴康洗液	药物
骶骼筋膜脂肪疝	疾病
盐酸土霉素片	药物
七维牛磺酸口服溶液	药物
美替沙腙	药物
骨愈灵胶囊	药物
保和液	药物
梁财信跌打丸	药物
手湿疹	疾病
体温调节紊乱	症状
卡拉美芬	药物
妊娠合并肾病综合征	疾病
格列波脲	药物
关节畸形	症状
九龙解毒胶囊	药物
膦甲酸钠乳膏	药物
肛内轻微隐痛坠胀或不适感	症状
牛黄清心丸	药物
琥珀酸舒马普坦	药物
小儿消咳片	药物
肠胃宁片	药物
中风安口服液	药物
酮康唑片	药物
眼睑畸形	症状
胃膜素胶囊	药物
肾上腺中毒	疾病
老年眩晕	疾病
肺通气一血流比例失调	症状
小儿唐氏综合征	疾病
关节强硬	症状
小儿休克	疾病
恶性胸水	症状
氯屈膦酸二钠胶囊	药物
言语凌乱	症状
银黄咀嚼片	药物
收缩期震颤	症状
男性不育症	疾病
壮阳春胶囊	药物
益心宁神片	药物
Kartagener综合征	疾病
多潘立酮混悬液	药物
糠酸莫米松	药物
包醛氧淀粉胶囊	药物
赖利-戴综合征	疾病
果糖	药物
抗类风湿性关节炎33抗体	检查科目
术后急性精神障碍	症状
类香味菌	NoneType
珍宝解毒胶囊	药物
奎宁	药物
血小板凝集功能试验	检查科目
红细胞谷胱甘肽还原酶	检查科目
香菊片	药物
富马酸亚铁多库酯钠胶囊	药物
丹栀逍遥丸	药物
骨剌片	药物
少阳感冒颗粒	药物
肱动脉损伤	疾病
达肝素钠	药物
酯香微杆菌	NoneType
尺管综合征	疾病
溃疡颗粒	药物
黄指甲	症状
生殖泌尿道危象	症状
咽速康气雾剂	药物
腹满	症状
小儿枸磺新啶片	药物
心脑健胶囊	药物
再造丸	药物
抗人免疫球蛋白轻链k型诊断血清	药物
特发性黄斑部前膜	疾病
胸口紧绷	症状
西地那非	药物
单硝酸异山梨酯胶囊	药物
喉麻痹	病毒
痔血胶囊	药物
便秘	NoneType
铋镁豆蔻片	药物
焦油性黑变病	疾病
肝肿大	症状
动脉造影异常	症状
盐酸帕罗西汀片	药物
复方过氧化氢释氧剂	药物
镇江膏药	药物
小儿片吸虫病	疾病
金泽冠心胶囊	药物
单核细胞增生利斯特菌	NoneType
先天性小眼球合并眼眶囊肿	疾病
蟹睛	疾病
耻骨炎	疾病
慢性非特异性唇炎	疾病
血清铜	检查科目
痰喘片	药物
麻姜颗粒	药物
小儿清热宣肺贴膏	药物
小儿支气管肺发育不全	疾病
小儿吐泻宁散	药物
脊柱侧凸	疾病
血塞通胶囊	药物
保儿宁糖浆	药物
华山参气雾剂	药物
奥芬溴铵片	药物
精神心理科	医学专科
脊疳	疾病
盐酸精氨酸片	药物
甲泛葡胺	药物
小儿纵隔压迫综合征	疾病
吗氯贝胺胶囊	药物
多形性腺瘤	疾病
抗栓再造丸	药物
锥虫性“下疳”	症状
结核性脓胸	疾病
无故发笑	NoneType
疟疾肾病	疾病
降糖通脉胶囊	药物
红细胞呈钱串状	症状
老年人脂肪肝	疾病
眼灵注射液	药物
益胃膏	药物
藿香正气胶囊	药物
注射用头孢硫脒	药物
三氮唑核苷注射液	药物
抽风	症状
注射用西咪替丁	药物
小儿弱视	疾病
蟹黄肤宁软膏	药物
乌鸡丸	药物
森林脑炎灭活疫苗	药物
血浆蛋白检测试剂冻干补体成份C3抗血清	NoneType
尿失禁	NoneType
咳喘清片	药物
躯体化障碍	症状
糠秕孢子菌毛囊炎	疾病
创伤性耳聋	疾病
腹膜后间隙出血	疾病
肺出血－肾炎综合征	疾病
滑囊炎	疾病
复方呋噻米片	药物
急性胃扩张	NoneType
缺血性脑卒中	疾病
乳酸左氧氟沙星滴眼液	药物
健脾壮腰药酒	药物
固氮菌	NoneType
老年人颅内压增高	疾病
复方皮维碘溶液	药物
阴囊炎性癌	疾病
阴毛早发育	症状
复方氨基酸胶囊	药物
加替沙星片	药物
钩端螺旋体菌苗	药物
小儿高黏稠综合征	疾病
游离三碘甲状腺原氨酸指数	检查科目
双羟萘酸噻嘧啶颗粒	药物
胆木浸膏糖浆	药物
痛经	NoneType
尼美舒利凝胶	药物
雪山金罗汉止痛涂膜剂	药物
鳖甲消痔胶囊	药物
男性乳腺癌	疾病
心功能障碍	疾病
健脾理肠片	药物
盐酸赖氨酸散	药物
盐酸加替沙星胶囊	药物
甲橙维C咀嚼片	药物
蛔虫感染	NoneType
补心气口服液	药物
复方磷酸可待因口服溶液	药物
巨细胞肉芽肿	疾病
小儿原发性甲状旁腺功能亢进症	疾病
海马强肾丸	药物
原发性纵隔感染	疾病
多维铁口服溶液	药物
链核盘菌	细菌
复方忍冬野菊感冒片	药物
盐酸洛美沙星分散片	药物
环氯茚酸	药物
骨髓病性贫血	疾病
曲克芦丁口服溶液	药物
脑脊液铅	检查科目
独一味颗粒	药物
三碘甲状腺原氨酸摄取率	检查科目
鱼腥草素钠片	药物
复方枣仁胶囊	药物
急性腮腺炎性睾丸炎	疾病
奥扎格雷钠氯化钠注射液	药物
角层下脓疱性皮肤病	疾病
脑脊液结核性脑膜炎抗体	检查科目
清热解毒泡腾片	药物
胃尔宁片	药物
无月经来潮	症状
乳酸片球菌	NoneType
清喉咽冲剂	药物
硫辛酸	药物
老年人高钾血症	疾病
阴道口局部红肿热痛	NoneType
甘珀酸钠	药物
小儿骨髓增生异常综合征	疾病
阿那日八味散	药物
早孕反应	疾病
先天性声带发育不良	疾病
声带萎缩	症状
重组人表皮生长因子衍生物滴眼剂	药物
小儿疳渴	疾病
肠道病毒所致各系统感染	疾病
舒托必利	药物
百梅止咳糖浆	药物
烧伤后急性呼吸窘迫综合征	疾病
聚普瑞锌	药物
尿戊糖	NoneType
蛇胆川贝口服液	药物
盐酸氯米帕明注射液	药物
感冒清热冲剂	药物
秦归活络口服液	药物
克伤痛气雾剂	药物
八星虎甲	NoneType
发作性傻笑	症状
血复生片	药物
湿性坏疽	症状
依匹唑	药物
氯氟舒松软膏	药物
涎腺良性肥大	疾病
祛痰止咳颗粒	药物
抗生链霉菌	NoneType
失血过多	症状
肌肉发育不良	症状
脊椎结核寒性脓肿穿入空腔脏器	疾病
四肢无力	NoneType
河车补丸	药物
气管和纵隔移位	症状
蔗糖-异麦芽糖吸收不良	症状
上清丸	药物
柴黄口服液	药物
阴结	疾病
躯体疾病伴发的精神障碍	疾病
软产道异常性难产	疾病
不能向尺侧屈腕及屈环小指远侧指关节	症状
青兰浸膏片	药物
泼尼莫司汀	药物
妇炎康丸	药物
绝经期面红	症状
薄荷油	药物
α1抗胰蛋白酶缺乏性肝病	疾病
先天性肠闭锁	疾病
磺胺二甲基嘧啶	药物
精液不液化	疾病
雷公藤多甙片	药物
乐脉片	药物
健脾八珍糕	NoneType
消散延迟性肺炎	疾病
沥水调脂胶囊	药物
呈泡沫样有腥臭味稀便	症状
多脂长喙壳	NoneType
环孢素口服溶液	药物
小儿指甲-髌骨综合征	疾病
毛细血管搏动	症状
磷酸吡哆醛丁咯地尔胶囊	药物
肘部剧烈疼痛，压痛肿胀	NoneType
宫颈息肉	疾病
肺宁胶囊	药物
紫霉素	药物
丹皮酚片	药物
火激红斑	疾病
橘红冲剂	药物
黄杆菌属	细菌
罗红霉素颗粒剂	药物
结核性葡萄膜炎	疾病
鼠抗大分子角蛋白单克隆抗体	检查科目
硫磺硼砂乳膏	药物
巨肠症	疾病
月经周期性精神病	疾病
外阴上皮样肉瘤	疾病
痢特敏片	药物
志贺氏菌属诊断血清	NoneType
奥曲肽	药物
双半胱氨酸	NoneType
当归龙荟片	药物
桔远止咳片	药物
附桂骨痛胶囊	药物
卵磷脂片	药物
水母头征	NoneType
幽门管狭窄	症状
淋病	疾病
血精症	疾病
牛尾蒿油滴丸	药物
丹绿补肾胶囊	药物
炔雌醇片	药物
抗双链DNA抗体	检查科目
斑蝥素	药物
粘质沙雷氏菌	NoneType
粪气味	检查科目
匹多莫德散	药物
五味沙棘含片	药物
新生儿低钠血症	疾病
酒石酸美托洛尔缓释片	药物
桑毛虫皮炎	疾病
溴丙胺太林	药物
氨酚氯雷伪麻缓释片	药物
硫普罗宁片	药物
宁心宝口服液	药物
阿斯伯格综合症	疾病
严重急性呼吸道症	疾病
氢化可的松琥珀酸钠	药物
输卵管肿瘤	疾病
洛伐他汀	药物
慢肝解郁丸	药物
维生素EC片	药物
抗卵巢抗体阳性	症状
盐酸伐昔洛韦分散片	药物
黏液囊肿	疾病
温肾前列胶囊	药物
弹性酶肠溶片	药物
心脏转移	症状
多毛症	疾病
银翘合剂	药物
呋喃西林	药物
婴儿脐疝	药物
七十味珍珠丸	药物
肺部化脓性感染	症状
浅静脉有一发红低热的索状物	症状
造口旁疝	疾病
妊娠合并肺炎	疾病
情志内伤	NoneType
营养不良性皮肤钙化病	疾病
四妙丸	药物
肺炎杆菌肺炎	疾病
琥珀安神丸	药物
孕妇胸闷气短	症状
氨酚烷胺那敏胶囊	药物
甘草酸二铵葡萄糖注射液	药物
盐酸氨溴索缓释小丸	药物
小檗碱	药物
回乳	疾病
肾康宁片	药物
母乳多颗粒	药物
抗磷脂抗体综合征	疾病
二母安嗽丸	药物
深感觉障碍	症状
食管受压性吞咽困难	疾病
麝雄至宝丸	药物
穿心莲胶囊	药物
脑干病变	症状
丙型肝炎病毒抗体诊断试剂盒(酶联免疫法)	药物
盐酸哌仑西平片	药物
苹果酸脱氢酶	检查科目
甲苯咪唑咀嚼片	药物
脾胃舒丸	药物
银花芒果颗粒	药物
咖啡因与氨茶碱中毒	疾病
琥珀酸亚铁片	药物
心达康胶囊	药物
尿液细菌培养	检查科目
中性粒细胞减少症	疾病
肥厚瘢痕	症状
妇炎舒胶囊	药物
血浆蛋白C抗原	检查科目
利胆排石散	药物
乙型肝炎病毒表面抗体诊断试剂盒(放射免疫法)	药物
肺芽生菌病	疾病
醋酸甲羟孕酮片	药物
止咳梨浆	药物
舒肝止痛丸	药物
阿莫西林分散片	药物
氯化钙溴化钠注射液	药物
乳杆菌	药物
口腔科	医学专科
马尔尼菲青霉病	疾病
三七冠心宁片	药物
华根霉	细菌
小角膜	NoneType
甲磺酸左氧氟沙星	药物
夹色伤寒	疾病
Kallmann综合征	疾病
阑尾灵颗粒	药物
氨基甲酸酯类农药中毒	疾病
额叶癫痫的“击剑姿势”	症状
灵魂鸦片	药物
寒湿困脾	疾病
香莲丸	药物
乙酰吉他霉素颗粒	药物
血红蛋白抗碱试验	检查科目
黄连上清丸	药物
小儿再发性腹痛	疾病
痛可宁注射液	药物
大楼病综合征	疾病
复方碳酸氢钠片	药物
阿莫西林钠	药物
发热伴有皮疹	症状
红细胞平均血红蛋白量	检查科目
复发性阿弗他性口腔炎	疾病
痰浊眩晕	疾病
小书写症	疾病
人为脂膜炎	疾病
言语自动症	疾病
乳酸钠	药物
复方毛冬青氯贝酸铝片	药物
老人行动迟缓	症状
盐酸半胱氨酸	药物
大黄利胆胶囊	药物
声门水肿	NoneType
强迫型人格障碍	NoneType
阿洪病	疾病
妇科宁坤丸	药物
小儿健脾止泻丸	药物
神经束损伤断裂	症状
柳氮磺吡啶	药物
伤湿止痛搽剂	药物
甲泼尼龙	药物
三黄清解片	药物
铝镁司片	药物
毛发囊肿	疾病
血清纤维结合蛋白	检查科目
浅绿气球菌	NoneType
小儿出血性疾病	疾病
卡马西平片	药物
肺安片	药物
痰液量	NoneType
橘红丸	药物
解痉镇痛酊	药物
小儿潮红综合征	疾病
刺五加片	药物
股外侧皮神经病	疾病
氯氟卓乙酯	药物
蜕膜残留	症状
指甲-髌骨综合征	疾病
C肽	检查科目
脾虚泄泻	疾病
蛤蚧党参膏	药物
毒奶粉	NoneType
阿芬太尼	药物
尿酮体试验	检查科目
外用紫金锭	药物
壬二酸乳膏	药物
表皮痣	疾病
家族性黏液血管纤维瘤	疾病
儿童口吃	疾病
复杂性醉酒	症状
玉叶清火片	药物
紫绀和血缺氧	症状
小儿气管支气管异物	疾病
肠蠕动减慢	NoneType
虚疟	疾病
淋菌性结膜炎	疾病
醒脾养儿胶囊	药物
碳酸钙胶囊	药物
数学	NoneType
过岗龙片	药物
小儿结节性硬化综合征	疾病
气性坏疽	疾病
止咳酮	药物
甲型流感病毒	症状
非淋菌性尿道炎	疾病
皮肤含铁血黄素沉着	症状
尿氟	检查科目
九气拈痛胶囊	药物
固肾安胎丸	药物
胃癌	疾病
氯化钾颗粒	药物
奎尼丁	药物
小儿久嗽丸	药物
恶性多形性腺瘤	疾病
肾融合	疾病
小儿丙酸血症	疾病
食管中段憩室	疾病
蜕膜反应	症状
眉弓囊肿	疾病
自发性腹膜后出血或血肿	疾病
桂利嗪胶囊	药物
甘露聚糖肽注射液	药物
温热	疾病
复方胆通胶囊	药物
知柏地黄丸浓缩丸	药物
龙燕补肾酒	药物
耳内脑膜脑疝	疾病
鱼鳔补肾丸	药物
溴苯那敏	药物
青春发育延迟及性幼稚	疾病
跖管综合征	疾病
消癌平颗粒	药物
匹米诺定	药物
复方雪莲胶囊	药物
天疱疮	疾病
合水粉葛	NoneType
阿昔洛韦缓释片	药物
老年人原发性高血压引起的良性小动脉肾硬化	疾病
迟钝爱德华氏菌	NoneType
自身敏感性皮炎	疾病
胞磷胆碱钠片	药物
生乳汁	药物
意志丧失性格	症状
健儿疳积散	药物
氧氟沙星乳膏	药物
六味壮骨颗粒	药物
清肝颗粒	药物
清热凉茶	药物
新单亲子女	NoneType
腰息痛	NoneType
四氯化碳中毒	疾病
前列腺钙化	NoneType
阿那格雷	药物
矽肺	疾病
副肿瘤性小脑变性	疾病
猝倒	症状
牡荆油乳	NoneType
泛昔洛韦胶囊	药物
抗狼疮散	药物
脑外伤所致精神障碍	疾病
小儿肺咳颗粒	药物
梨状肌综合征	疾病
胃得安片	药物
感速康胶囊	药物
静脉血栓	症状
胆囊收缩功能不良	NoneType
血宁糖浆	药物
痉笑面容	症状
胰腺多肽瘤	疾病
视空间功能受损	症状
瘢痕疙瘩	疾病
心阴虚	疾病
碘化钾片	药物
舒巴坦匹酯	药物
奥替溴铵	药物
氰化物烧伤及合并中毒	疾病
经行泄水	疾病
老年人急性阑尾炎	疾病
青光眼	疾病
菊糖	药物
阿莫西林氟氯西林	药物
渴乐宁胶囊	药物
维U颠茄铝胶囊	药物
痞气	疾病
维生素C颗粒剂	药物
粪结核杆菌检查	检查科目
醋酸氯己定	NoneType
假性近视	症状
氯胺酮	药物
抗生素诱发的肠炎	疾病
浆细胞瘤	疾病
曲克芦丁片	药物
灯盏花素氯化钠注射液	药物
陈香露白露胶囊	药物
窦性停搏	症状
葡萄糖酸氯己定溶液	药物
情绪性哮喘	症状
掌跖多汗	症状
三环类抗忧郁药中毒	疾病
肺炭疽	疾病
醒消丸	药物
健脾康儿片	药物
口腔颌面部软组织损伤	疾病
呋脲苄西林钠	药物
食管反流症状	症状
血液粘滞度增高	症状
呋布西林钠	药物
偏身萎缩	症状
润肺化痰丸	药物
决明平脂胶囊	药物
小儿退热口服液	药物
横膜马勃	NoneType
益肝灵分散片	药物
痢泻灵片	药物
强迫性神经官能症	症状
香苏调胃片	药物
外伤性低位截瘫	症状
替卡西林钠	药物
三叉神经一二支分布区域疼痛	症状
复方肝浸膏片	药物
股骨髁上骨折	疾病
青果颗粒	药物
小儿肌阵挛性癫痫	疾病
急性脂肪皮肤硬化症	疾病
脑脊髓膜浸润	症状
耳内流脓	症状
血清锌	检查科目
克矽平	药物
双氯西林	药物
五味治肝片	药物
铝钠颠茄片	药物
氯屈膦酸二钠注射液	药物
粪便中排出的粪胆原增加	症状
周围神经损伤	疾病
蛇胆陈皮化痰散	药物
乳头内陷	疾病
乳房纤维腺瘤	疾病
下腹胀痛	症状
智力减低	症状
左上腹囊性包块有压痛	症状
通络活血丸	药物
曲克芦丁羟丙茶碱片	药物
粘连性肠梗阻	疾病
牛黄解毒片	药物
复方乙胺嘧啶片	药物
扶正康颗粒	药物
鞣酸蛋白	药物
炉甘石粉	NoneType
X型腿	NoneType
银冰含片	药物
简单节杆菌	NoneType
枸橼酸锌	药物
胶冻样芽胞杆菌	NoneType
毛细血管扩张性环状紫癜	疾病
皮肤花纹	症状
皮肤撕脱伤	症状
卡前列甲酯	药物
黄藤素软胶囊	药物
头孢羟氨苄颗粒剂	药物
脑脊液脂质过氧化物	检查科目
肾炎消肿片	药物
苯甲酸雌二醇注射液	药物
肥胖	NoneType
理中片	药物
盐酸格拉司琼氯化钠注射液	药物
十二指肠憩室梗阻性黄疸综合征	疾病
盐酸阿夫唑嗪片	药物
单眼失明	症状
慢性肺源性心脏病	疾病
多非利特	药物
依托度酸	药物
冠心病	疾病
维U颠茄铝镁片II	药物
扎那米韦	药物
胃液乳酸脱氢酶同工酶	检查科目
肥胖性水肿	症状
情绪性胃痛	症状
胸骨压痛	症状
项痹	疾病
注射用亚锡葡萄糖酸钙	药物
元胡止痛片	药物
浓碘甘油	NoneType
滑膜黑染	症状
手部血管损伤	疾病
八味安宁散	药物
安神糖浆	药物
癃开颗粒	药物
固本延龄丸	药物
鼻炎康片	药物
胆维丁片	药物
喉痹	疾病
左氧氟沙星葡萄糖注射液	药物
盐酸仑氨西林片	药物
米雅	药物
果导片	药物
易激动	症状
绒毛膜促性腺激素放免药盒	药物
银杏叶丸	药物
癌症晚期胃肠道症状	症状
卵巢癌	疾病
急性失血性贫血	疾病
输卵管妊娠流产	疾病
溴凡克新	药物
低分子量肝素钙注射液	药物
吡罗昔康贴片	药物
运动员胸背与腰背痛	疾病
胎位不正	病毒
肛管直肠恶性黑色素瘤	疾病
指骨骨折	疾病
葡萄糖酸锑钠	药物
瘰疬性皮肤结核病	疾病
黏脂贮积症Ⅰ型	NoneType
氟司洛尔	药物
吸附百日咳白喉联合疫苗	药物
可愈糖浆	药物
发热伴淋巴结肿大、并伴触痛	NoneType
甲酚磺酸	药物
胎盘老化	NoneType
六味安消片	药物
小儿真菌感染性口炎	疾病
小儿慢性胰腺炎	疾病
网状红斑萎缩性毛囊炎	疾病
兰索拉唑	药物
麻痹性痴呆	疾病
皮损可呈角样突起	症状
延胡胃安胶囊	药物
益脉康片	药物
六氯对二甲苯	药物
QRS波宽大畸形	症状
参茸延龄片	药物
咳嗽性哮喘	疾病
烧伤后急性肾功能衰竭	疾病
孔圣枕中丸	药物
金花消痤丸	药物
奥沙拉秦钠	药物
暖宫七味丸	药物
小儿周期性低血钾性麻痹	疾病
滑脱性肋骨综合征	疾病
注射用丹参多酚酸盐	药物
缺血性挛缩	症状
老年人睡眠障碍	疾病
青霉素V钾颗粒	药物
十一味参芪片	药物
O1群霍乱弧菌检测试剂盒(胶体金法)	药物
注射用双氯芬酸钠利多卡因	药物
播散性嗜酸粒细胞增多性胶原病	疾病
陇马陆胃药胶囊	药物
小儿营养不良	疾病
盐酸赛克力嗪	药物
六味丸	药物
抗甲状腺微粒体抗体	检查科目
貂油治裂软膏	药物
盐酸妥洛特罗片	药物
肾间质纤维化	症状
山香圆片	药物
龟鹿补肾丸	药物
萘普生注射液	药物
激素抵抗型哮喘	疾病
手指甲周围起皮	症状
弯腰时腰痛	症状
莓叶委陵菜片	药物
老年人肺心病	疾病
鑫皓天玉米油	NoneType
经舒胶囊	药物
小儿急性阑尾炎	疾病
曲霉球	疾病
低密度脂蛋白胆固醇	检查科目
右美沙芬愈创甘油醚糖浆	药物
皮炎平	药物
乳腺癌	疾病
水痘样皮疹	症状
去乙酰毛花甙丙	NoneType
急性附睾炎	疾病
百癣夏塔热片	药物
儿童性别偏差	症状
生脉散	药物
金胆片	药物
隆突性皮肤纤维肉瘤	疾病
肠道转运障碍	症状
睑板腺囊肿	疾病
注射用核黄素磷酸钠	药物
迷路震荡	疾病
温清饮	药物
耳垂长痘	症状
维血宁	药物
尼美舒利干混悬剂	药物
通窍镇痛散	药物
聚维酮碘散	药物
满山香片	药物
故宫	NoneType
肾小管酸化功能障碍	症状
齿龈增生	症状
盐酸丁咯地尔葡萄糖注射液	药物
盐酸阿呋唑嗪片	药物
醋酸可的松眼液	药物
索罗玛宝颗粒	药物
西罗莫司口服溶液	药物
持续性弛张热	症状
食管梗阻	症状
自主神经反射	症状
细胞色素注射液	药物
阿司匹林缓释胶囊	药物
小儿食积	疾病
暖胃舒乐片	药物
烟酸缓释胶囊	药物
维生素E烟酸酯软胶囊	药物
西托溴铵	药物
小儿营养不良性消瘦	疾病
甲苯磺酸托氟沙星胶囊	药物
双手震颤	症状
小指感觉消失	症状
新生儿佝偻病	疾病
盐酸地尔硫卓控释胶囊	药物
局部灼热	症状
经行舌麻	疾病
帕罗西汀	药物
盐酸左旋氧氟沙星	药物
氧-16	NoneType
食管溃疡	症状
二丁颗粒	药物
急性阴道感染	症状
外周静脉充勇	症状
注射用灯盏花素	药物
小儿发作性睡病	疾病
反射性交感神经营养不良综合征	疾病
葡甲胺	药物
心可舒	药物
麝香正骨酊	药物
克霉唑乳膏	药物
舌淡体胖	症状
女贞叶乙醇提取物	NoneType
轻压指甲，指头微红状不能马上恢复	NoneType
烟酸占替诺葡萄糖注射液	药物
盐酸倍他司汀氯化钠注射液	药物
贫血貌	症状
软腭运动不对称	症状
清肝扶正胶囊	药物
口底癌	疾病
新疆出血热	疾病
跌打丸	药物
福康片	药物
醋酸氢化可的松滴眼液	药物
小儿贲门失弛缓症	疾病
蟾酥锭	药物
发作性嗜睡强食综合征	疾病
健肝灵片	药物
肾肝宁胶囊	药物
复方北豆根氨酚那敏片	药物
五维葡钙口服溶液	药物
晨僵	症状
消痤丸	药物
氯米帕明	药物
金砂五淋丸	药物
盐酸多利卡因注射液	药物
五仁醇软胶囊	药物
浅表淋巴结肿大	症状
注射用硫酸普拉睾酮钠	药物
皮脂腺癌	疾病
膀胱结核	疾病
噎膈	疾病
眼眶脂肪肉瘤	疾病
盐酸罗格列酮片	药物
血清免疫球蛋白G亚类	药物
葡萄糖氯化钠注射液	药物
伤寒性心肌炎	疾病
氟尿嘧啶片	药物
当归丸	药物
恩曲他滨	药物
调经活血片	药物
金钱草片	药物
藿香正气滴丸	药物
硝基四唑氮蓝试验	检查科目
脓痱	NoneType
汉语能力测试	NoneType
妇科止血灵片	药物
严重联合免疫缺陷病	疾病
老年人前列腺增生症	疾病
盐酸托烷司琼	药物
畸形性吞咽困难	疾病
小儿止泻贴	NoneType
驱虫斑鸠菊注射液	药物
肋柱花四味汤散	药物
喉水肿	疾病
环孢素	NoneType
盐酸川芎嗪氯化钠注射液	药物
小儿非内脂性网状内皮增殖综合征	疾病
抗饥消渴片	药物
蒿蓝感冒颗粒	药物
鱼肝油乳	药物
格列吡嗪控释片	药物
间歇性失忆	症状
呼吸性酸中毒	疾病
抗磷脂抗体	检查科目
睾丸萎缩	症状
小儿透析失衡综合征	疾病
天香酊	药物
绝经与心血管疾病	疾病
骨折不愈合	疾病
膀胱白斑病	疾病
清热二十五味丸	药物
脑心清胶囊	药物
二甲硅油散	药物
体毛脱落	症状
风轮止血片	药物
青红丘疹	症状
颌骨造釉细胞瘤	疾病
复方银花解毒颗粒	药物
盐酸丁咯地尔氯化钠注射液	药物
磺酸钠	药物
苄达赖氨酸滴眼液	药物
桔贝止咳祛痰片	药物
低分子肝素钙	NoneType
脏连丸	药物
口角肌肉的抽搐	症状
胃容纳性减弱	症状
消化性溃疡	疾病
血塞通分散片	药物
十三味青兰散	药物
利肝片	药物
胎痣	NoneType
肛周囊肿	疾病
黄体酮注射液	药物
全身持续性水肿	症状
盐酸普罗帕酮注射液	药物
眶内海绵状血管瘤	疾病
小颌畸形综合征	疾病
更年欣胶囊	药物
复方蒲芩片	药物
人参保肺丸	药物
复方银耳鱼肝油	药物
言语紊乱	症状
盐酸雷尼替丁片	药物
藻酸双酯钠	药物
乳汁吸入性肺炎	疾病
乙酰吉他霉素片	药物
雄激素过少	症状
复方桔梗氯化铵糖浆	药物
肥儿散	药物
深黄色或带绿色的水样便	症状
肛周软瘊	症状
云芝肝泰胶囊	药物
盐酸利多卡因葡萄糖注射液	药物
头皮触痛	症状
冻干人凝血酶	药物
复方灵芝颗粒	药物
小儿慢性肺炎	疾病
金诺芬	药物
复方蛤青胶囊	药物
溶血素	NoneType
炔诺酮片	药物
亚甲蓝	NoneType
三肾温阳酒	NoneType
食管瘘	症状
孕妇腿抽筋	症状
小儿过敏性紫癜	疾病
PAS染色阳性	症状
神经系统的放射性损伤	疾病
大黄	NoneType
痹痛宁胶囊	药物
夹层血肿	症状
痛经宝颗粒	药物
先天性喉软化症	疾病
硫酸纸	NoneType
酮康唑霜	NoneType
产后头痛	症状
磁朱丸	药物
短杆菌	NoneType
心内膜炎	疾病
小儿白细胞黏附分子缺陷Ⅱ型	疾病
桑姜感冒胶囊	药物
金黄散	药物
甘露聚糖肽口服液	药物
小儿糖原贮积病Ⅸ型	NoneType
复合氨基酸注射液(6AA)	药物
脐膨出	疾病
猴耳环消炎片	药物
手术创伤	症状
云芝糖肽胶囊	药物
真菌性肠炎	疾病
参皇软膏	药物
尿嘧啶替加氟片	药物
多维片(6)	药物
尼卡地平	NoneType
艾司唑仑注射液	药物
替硝唑含片	药物
重症肌无力样综合征	疾病
复方樟脑酊	药物
红花清肝十三味丸	药物
新生儿脓漏眼	症状
支气管中心性肉芽肿病	疾病
脐带血循环障碍	症状
多糖铁	药物
糖尿病心脏病	疾病
米氮平	药物
地屈孕酮	药物
不完全性肠梗阻	NoneType
克罗米通乳膏	药物
泪腺肿瘤	疾病
先天性风疹	疾病
乳房内光滑质韧的球形肿块	症状
跌打风湿酒	药物
解毒护肝颗粒	药物
血宁胶囊	药物
头孢丙烯	药物
痛风结节	症状
羧甲司坦片	药物
地布酸钠	药物
阿尔采末病	疾病
肢端肥大症	疾病
蒿甲醚注射液	药物
复方氨基酸注射液(18AA)	药物
口腔红斑	疾病
吡嘧司特钾滴眼液	药物
阿米卡星洗剂	药物
左旋多巴片	药物
归羊冲剂	药物
厄多司坦	药物
特异性肾实质疾病	疾病
中毒性紫癜	疾病
芩暴红止咳胶囊	药物
职业黑变病	疾病
小腿动脉损伤	疾病
小儿扶脾颗粒	药物
阴蒂肥大	症状
麻疹腮腺炎风疹活病毒疫苗	药物
止咳橘红颗粒	药物
肾脓肿	NoneType
枸橼酸铋雷尼替丁胶囊	药物
先天性胆道闭锁	疾病
伏立康唑片	药物
呼吸困难	症状
血沉增快	症状
阿昔洛韦滴眼液	药物
脑棘球蚴病	疾病
衰老加快	症状
表虚感冒颗粒	药物
罗沙前列醇	药物
盐酸吗啉胍注射液	药物
胃溃疡片	药物
下腰部疼痛	症状
显微型多血管炎	疾病
人类免疫缺陷病毒抗体HIV1/2/O诊断试剂盒酶联免疫法	药物
神经内分泌肿瘤	疾病
萘普生钠片	药物
益肾养元颗粒	药物
杏丁注射液	药物
甘糖酯片	药物
口腔黏膜黄豆大小，半透明的无痛小疱	NoneType
肺鼠疫	疾病
舒肝和胃口服液	药物
口腔粘膜有形似奶块的斑膜	症状
非特异性外阴炎	疾病
胆道结石	NoneType
乳酸菌素颗粒	药物
痰检阴性	症状
白血病细胞浸润	症状
鹅掌风药水	药物
开胃健脾丸	药物
反向搏动	症状
益气聪明丸	药物
酒精所致精神障碍	疾病
先天性无转铁蛋白血症	疾病
小儿锌缺乏症	疾病
乳溢症	疾病
齿痛宁	药物
心脏破裂	症状
藿香正气水	药物
抗菌药中毒性肾病	疾病
川贝清肺糖浆	药物
表皮全层坏死及表皮下大疱	症状
当归龙荟丸	药物
丙酸倍他米松	NoneType
咽食管憩室	疾病
手的歪扭畸形	症状
发热伴出血	症状
尺桡骨干双骨折	疾病
纳米炭	药物
心肌桥	疾病
香砂和中丸	药物
乙型肝炎核心抗原	检查科目
外科皮脂腺囊肿	疾病
鼻咽癌	疾病
氧化淀粉	药物
身体变形障碍	症状
幼年型疱疹样皮炎	疾病
尼莫地平胶丸	药物
注射用细辛脑	药物
组胺	药物
阴道痉挛	NoneType
阴道脱垂	疾病
曲安奈德鼻喷雾剂	药物
复方磺胺甲噁唑	药物
肉孢子虫病	疾病
了哥王片	药物
视网膜色素变性	疾病
五更太平丸	药物
精神分裂症	疾病
外阴皮肤脂溢性皮炎	疾病
七味沙参汤散	药物
背部弹力纤维瘤	疾病
川芎茶调滴丸	药物
喉部痉挛	症状
复方柳菊颗粒	药物
腮腺囊肿	疾病
脓毒性休克	疾病
小儿精神发育迟缓	疾病
别嘌醇片	药物
脊柱的成角畸形	症状
包皮炎	疾病
狼疮丸	药物
早熟性儿童乳房肥大症	疾病
马洛替酯片	药物
沉香散	药物
下肢动脉硬化闭塞症	疾病
颜面潮红	症状
痫症镇心丸	药物
盐酸齐拉西酮片	药物
头发分叉	症状
血清钾	NoneType
小儿原发型肺结核	疾病
表皮葡萄球菌肺炎	疾病
硫酸抗敌素	NoneType
头孢羟氨苄颗粒	药物
小儿致心律失常性右室心肌病	疾病
硝酸咪康唑阴道用软胶囊	药物
前列腺特异性抗原	检查科目
胶体酒石酸铋	药物
口腔痛	症状
知柏地黄丸(浓缩丸)	药物
肥厚型梗阻性心肌病	疾病
呼吸道合胞病毒感染	疾病
关节炎膏	药物
癔病性昏厥	疾病
新生儿皮下坏疽	疾病
肺部感染	症状
阴虚火旺	疾病
贲门弛缓	症状
肺部转移	症状
洛索洛芬钠胶囊	药物
窦室传导	疾病
高雄激素血症	症状
麝香祛痛气雾剂	药物
盐酸维拉帕米缓释胶囊	药物
耳炎液	NoneType
脑膜癌病	疾病
老年人呼吸性酸中毒	疾病
加替沙星胶囊	药物
扁桃酸	NoneType
体液外渗	症状
羊膜腔感染	症状
混合瘤	疾病
盐酸四环素片	药物
重酒石酸去甲肾上腺素注射液	药物
胶体果胶铋干混悬剂	药物
盐酸二氧异丙嗪片	药物
延髓出血	症状
养心宁神丸	药物
肌甘口服溶液	NoneType
胫前黏液水肿	疾病
安坤颗粒	药物
肾后性肾衰	症状
周围神经炎	疾病
抗活化的蛋白C症	疾病
顺气化痰颗粒	药物
茜草双酯片	药物
新霉素	药物
小儿硬脑膜外血肿	NoneType
胎儿宫内骨折	症状
颐和春胶囊	药物
肛门疼痛	NoneType
颈痛颗粒	药物
老年人心源性休克	疾病
氨酚氯汀伪麻片	药物
盐酸克伦特罗片	药物
磷酸哌喹片	药物
地衣芽胞杆菌活菌制剂	药物
脑脊液钠	药物
奥拉米特片	药物
埃替非巴肽	药物
麻疹	疾病
米格来宁	药物
引阳索	NoneType
肺孢子丝菌病	疾病
呋喃硫胺	药物
舒肝益脾液	NoneType
鼻黏膜和鼻甲萎缩	症状
慈航胶囊	药物
颌突畸形	症状
氨茶碱片	药物
抗乙肝转移因子	药物
消结安胶囊	药物
伪麻美沙芬滴剂	药物
急性腹型-高脂血症综合征	疾病
心肌梗塞并发左心室室壁瘤	疾病
利肝隆颗粒	药物
芪枣冲剂	药物
胃炎宁颗粒	药物
阿米巴原虫抗原和抗体	检查科目
复方对乙酰氨基酚片(II)	药物
止血宁片	药物
大量元素	NoneType
沙甲胺醇	药物
巨细胞病毒病	疾病
脾囊肿	疾病
盐酸洛美沙星颗粒	药物
黄精赞育胶囊	药物
解毒烧伤膏	药物
股三角区压痛	症状
卵巢肿瘤	疾病
头孢吡肟	药物
复方碳酸钙颗粒	药物
沉香安神胶囊	药物
磷霉素钠	药物
气过水声	症状
硫酸异丙肾上腺素注射液	药物
阿奇霉素软胶囊	药物
舒肝散	药物
苯甲酸利扎曲普坦	NoneType
感冒	NoneType
腕尺管综合征	疾病
口腔颌面部软组织肉瘤	疾病
佳胃得	药物
氨硫脲片	药物
头孢羟氨苄	NoneType
普通变形杆菌	细菌
多索茶碱注射液	药物
粘膜有粘着性白斑	症状
抗病毒滴丸	药物
小儿松果体区肿瘤	疾病
银杏蜜环口服溶液	药物
小肠腺瘤	疾病
化脓性中耳炎	疾病
丹曲林钠胶囊	药物
药物性哮喘	NoneType
盐酸坦索罗辛缓释胶囊	药物
核酪注射液	药物
硫酸胍乙啶片	药物
老鹳草膏	药物
醋酸泼尼松乳膏	药物
口唇泛红	症状
沙丁胺醇	药物
参芪博力康片	药物
肋痛	症状
巴柳氮钠	药物
马来酸依那普利片	药物
中心暗点或弓形暗点	症状
注射用更昔洛韦钠	药物
急性肺脓肿	疾病
加速性房性逸搏心律	疾病
酒精性胃黏膜损伤	症状
吸附白喉疫苗(成人及青少年用)	NoneType
肺炎链球菌败血症	疾病
妇女养血丸	药物
臀部放射痛	症状
胞磷胆碱钠	药物
糖原累积病	疾病
复合睾酮酯	药物
须部假毛囊炎	疾病
小儿情感交叉擦腿综合征	疾病
橡皮生肌膏	药物
维生素E片	药物
清眩片	药物
云芝肝泰颗粒	药物
血管内凝血	症状
L门冬氨酸氨氯地平片	药物
神经白塞病	疾病
注射用维生素C	药物
桔梗冬花片	药物
地拉卓	药物
胸腺五肽注射液	药物
阿托品异丙嗪注射液	药物
失用性综合征	疾病
参芪乌鸡养血膏	药物
复发性坏死性黏膜周围炎	疾病
九宝丸	药物
复方明胶纤维	药物
塞隆风湿酒	药物
康尔心颗粒	药物
肾间质受损	症状
夏季低热	疾病
活胃散	药物
棉尘肺	疾病
盐酸利多卡因氯化钠注射液	药物
螺旋藻胶囊	药物
肝脏类癌	疾病
额叶癫痫	疾病
醋酸环丙孕酮片	药物
非诺洛芬钙	药物
首乌补肾酒	药物
成年后的容貌仍似儿童	症状
烧伤灵酊	药物
疤痕萎缩凹陷	NoneType
他扎罗汀	药物
番泻叶颗粒	药物
氨苄西林颗粒	药物
顽固性疼痛	症状
婴儿喂养困难	症状
木耳舒筋丸	药物
输卵管肿块	症状
硝酸一叶秋碱注射液	药物
瘰疬分枝杆菌感染	疾病
稀盐酸	药物
比索洛尔	药物
醋氯芬酸	药物
椎管大小变化	症状
镇咳宁滴丸	药物
腰痛卧床加重	症状
X综合征	疾病
结合雌激素乳膏	药物
咽炎胶囊	药物
健脾片	药物
小儿糖原贮积病Ⅵ型	NoneType
清热化滞颗粒	药物
菊蓝抗流感颗粒	药物
二十六味通经胶囊	药物
颧骨额骨下陷	症状
直肠脱垂直肠壁内疝	疾病
宁心补肾丸	药物
桂蒲肾清胶囊	药物
丙型肝炎病毒抗体免疫球蛋白M	检查科目
四肢近端肌肉和呼吸麻痹	症状
加香甲酚皂溶液	药物
寰枢椎脱位	疾病
骨髓损害	症状
拉沙热	疾病
唇圆或椭圆形红斑	症状
游离甲状腺素放射免疫分析药盒	药物
鳖甲煎丸	药物
米非司酮片	药物
多司马酯	药物
皮肤油脂过多	症状
牛磺酸颗粒	药物
润燥止痒胶囊	药物
屈光不正性弱视	症状
孕三烯酮胶囊	药物
麻杏止咳膏	药物
注射用左氧氟沙星	药物
天疤疮	疾病
血吸虫间接血凝试验	检查科目
消痰咳片	药物
益身灵丸	药物
姿态性腰腿痛	疾病
口腔念珠菌病	疾病
盐酸雷尼替丁糖浆	药物
黄体功能不全	疾病
热烧伤	疾病
阿酚咖敏片	药物
流清涕	症状
碘帕醇注射液	药物
六味明目丸	药物
乳溢一高泌乳素血症	疾病
女劳疸	疾病
泡囊短波单胞菌	NoneType
尼索地平软胶囊	药物
血吸虫病与肝胆疾病	疾病
排便不尽感	症状
梅毒螺旋体抗体胶体金法检测试纸条	NoneType
白芝颗粒	药物
外感平安茶	药物
亚砷酸	药物
痔疾栓	药物
吸烟中毒症	疾病
塞克硝唑分散片	药物
复方海蛇胶囊	药物
指间关节不能屈曲	症状
西方马型脑炎	疾病
肝泰舒胶囊	药物
气管食管瘘	疾病
基底核钙化症	疾病
益气润肠膏	药物
美索达嗪	药物
耳后淋巴结肿大	症状
足趾痛	症状
对乙酰氨基酚丸	药物
儿童离别焦虑	症状
感觉过度	症状
高力清心丸	药物
黄藤素	药物
重度烧伤	症状
注射用奥扎格雷钠	药物
肢体增长、增粗过度	NoneType
妊娠性龈炎	疾病
咽康含片	药物
气血失和	症状
盐酸头孢吡肟	药物
复方氯唑沙宗片	药物
毒虫螫咬伤	疾病
谷丙甘氨酸胶囊	药物
七生静片	药物
小儿参术健脾丸	药物
甲壳胺	药物
腰部峡部崩裂和脊椎滑脱	疾病
诺迪康口服液	药物
奥硝唑注射液	药物
泛恶欲吐	症状
子宫内膜癌	疾病
龙虎人丹	药物
眼眶畸胎瘤	疾病
可乐定	药物
肝复乐	药物
复方驱虫斑鸠菊丸	药物
眼球震颤	NoneType
皮肤花斑样	症状
脾粉片	药物
甲状腺粉	药物
先天性颈椎齿状突畸形	疾病
舒尔经胶囊	药物
皮样囊肿	疾病
突发、无痛的局部水肿	NoneType
皮面上针头大小瘙痒点	症状
乙酰半胱氨酸注射液	药物
阿斯综合征	疾病
急性腰扭伤	疾病
注射用甲磺酸加替沙星	药物
苯巴比妥片	药物
盐酸左西替利嗪胶囊	药物
绞股蓝总甙	NoneType
暴力冲动行为	症状
昂丹司琼	药物
抗心肌细胞膜抗体	检查科目
白凤饮	NoneType
八正颗粒无糖型	NoneType
拉布立酶	药物
颈椎后脱位	疾病
他莫昔芬	药物
乙酰天麻素	NoneType
下蹲困难	症状
小儿血友病	疾病
注射用利巴韦林	药物
头孢曲松钠	药物
前臂和腕部的疼痛	症状
含硫钾	NoneType
颅内肿瘤	疾病
小汗腺血管错构瘤	疾病
搜风顺气丸	药物
乳酸依沙丫啶溶液	NoneType
止嗽咳喘宁糖浆	药物
乙肝病毒前S2抗体酶标试剂盒	药物
混合淋巴细胞培养试验	检查科目
当归调经颗粒	药物
脑力静颗粒	药物
褐黄病	疾病
盐酸托烷司琼胶囊	药物
急性肾炎综合征	疾病
眼球穿通伤	疾病
调肝和胃丸	药物
小儿惊风片	药物
葡萄糖氯化钠钾注射液	药物
甲吲洛尔	药物
马洛替酯	药物
先天性颅锁骨发育不全	NoneType
轻舒颗粒	药物
槐杞黄颗粒	药物
灌肠癖	症状
微循环障碍	症状
屈伸不利	NoneType
复方硫酸亚铁叶酸片	药物
吡拉西坦胶囊	药物
斑状萎缩	疾病
复方茶碱麻黄碱片	药物
急性硫化氢中毒	疾病
面痛	症状
肠狭窄	症状
先天性白血病	疾病
强肝糖浆	药物
脓尿	症状
《本草原始》	NoneType
粪胆素	检查科目
丁螺环酮	药物
水臌	疾病
曲司氯铵	药物
喘嗽宁片	药物
救必应胃痛胶囊	药物
杏苏止咳露	NoneType
小儿亚急性甲状腺炎	疾病
洁白丸	药物
慢性胆囊炎	疾病
氯马斯汀	药物
小儿急性非淋巴细胞性白血病	疾病
久痢丹	药物
清热除湿止泻颗粒	药物
喉痛灵冲剂	药物
利肝隆片	药物
食指不明原因疼痛	症状
层粘连蛋白	检查科目
虹膜蓝色	症状
原发性急性闭角型青光眼	疾病
参贝北瓜颗粒	药物
解毒通淋丸	药物
小儿嘌呤核苷酸磷酸化酶缺乏	疾病
癫痫的植物神经性发作	症状
清凉含片	药物
原发性青少年型青光眼	疾病
血浆蛋白检测试剂低密度脂蛋白(LDL)抗血清	NoneType
爆裂性眼眶骨折	疾病
左旋卡尼汀	药物
短棒菌苗	药物
左甲状腺素钠片	药物
头孢克洛	NoneType
风湿马钱片	药物
加替沙星注射液	药物
纵隔非霍奇金淋巴瘤	疾病
嗜酸性细胞胃肠炎	疾病
久芝清心丸	药物
衣原体淋巴肉芽肿	疾病
慢性劳损性颈背部筋膜纤维织炎	疾病
钩端螺旋体病	疾病
局灶性肾小球硬化症	疾病
急性腹膜炎	疾病
复方伤复宁膏	药物
ATE测试	NoneType
灵芝糖浆	药物
叶绿体	NoneType
丹花口服液	药物
美扑伪麻颗粒	药物
烧伤创面甜腥气味的粘稠分泌物	症状
继发性骨髓纤维化	疾病
赖氨酸磷酸氢钙片	药物
盐酸雷尼替丁泡腾颗粒剂	药物
梅毒螺旋体抗体胶体金检测试剂盒	药物
肢体过度肥大	症状
两面针镇痛片	药物
慢性中耳炎	疾病
益气止血颗粒	药物
家族性渗出性玻璃体视网膜病变	疾病
泻青丸	药物
清瘟解毒丸	药物
能安均宁胶囊	药物
舌两侧边缘毛状白斑	症状
八宝眼药	药物
肠毒性大肠埃希杆菌感染	疾病
舌下神经损伤	疾病
肺静脉异位引流	疾病
牙内陷	疾病
下半身消瘦型	症状
遗传性纤维蛋白原缺乏症	疾病
盐酸丁咯地尔胶囊	药物
复方嗜酸乳杆菌片	药物
降脂减肥片	药物
颅后窝室管膜瘤	疾病
健脾糕片	药物
狼疮性抗凝因子	NoneType
足背动脉搏动消失	症状
细菌性痢疾	疾病
丙氨酰谷氨酰胺注射液	药物
骨病	疾病
足畸形	症状
强力定眩片	药物
广州管圆线虫病	疾病
毛囊瘤	疾病
复合氨基酸9R注射剂	药物
胎死宫内	疾病
磷酸可待因缓释片	药物
唇炎	疾病
还少胶囊	药物
儿童头痛	症状
肝气犯肺	症状
眼睑湿疹	疾病
风湿安泰片	药物
胰腺囊腺癌	疾病
噩梦	症状
大风丸	药物
注射用盐酸纳洛酮	药物
雄烯二酮	药物
睫状充血	症状
牛磺酸滴眼液	药物
引阳索颗粒	药物
丙戊酸镁	药物
缺血性视盘病变	疾病
祛风湿膏	药物
表皮短杆菌	NoneType
硫酸特布他林胶囊	药物
小儿雄激素不敏感综合征	疾病
地高辛注射液	药物
甲状腺结核	疾病
葡萄糖耐量试验	检查科目
复方梨膏	药物
复方透骨香乳膏	药物
化学星空	NoneType
盐酸乌拉地尔注射液	药物
降压避风片	药物
无敌丹胶囊	药物
宫底及耻骨联合上方空虚	症状
复方电解质葡萄糖MG3注射液	药物
手指歪斜	症状
左羟丙哌嗪颗粒	药物
宫缩乏力	症状
睡安胶囊	药物
心胸外科	医学专科
黄花杜鹃滴丸	药物
恩曲他滨胶囊	药物
宁嗽丸	药物
映山红糖浆	药物
角形甲弧影	症状
注射用门冬氨酸钾镁	药物
对女性物品的非正常爱好	症状
旋前圆肌综合征	疾病
樟脑磺酸钠注射液	药物
高渗性昏迷	症状
富马酸福莫特罗	药物
茶苯海明片	药物
肠易激综合征	疾病
谵妄综合征及有关疾病	疾病
混合性结缔组织病	疾病
胸内异物	疾病
肺放线菌病	疾病
剧烈运动或强体力劳动后血尿	症状
结节性硬化	症状
肝达康颗粒	药物
肺部或支气管周围可呈现纹理增粗及浸润现象	症状
小儿支气管炎	疾病
小儿大动脉炎	疾病
复方呋喃西林散	药物
田七颗粒	药物
心内膜弹力纤维增生	NoneType
注射用奥硝唑	药物
肠鸣	症状
乳糜胸	疾病
利可君	药物
细菌性心包炎	疾病
古楼山跌打酒	NoneType
淋巴细胞毒试验	检查科目
上腹部疼痛	症状
间歇性胃痛	症状
地嗜皮菌属	细菌
小儿甲基丙二酸血症	疾病
斑状白化病	疾病
乳糖耐受不良	症状
室颤阈值降低	症状
地美环素	药物
多发性内分泌肿瘤综合征Ⅰ型	疾病
面神经损伤	疾病
三七血伤宁胶囊	药物
复方延胡索氢氧化铝片	药物
三硅酸镁片	药物
盐酸伊托必利胶囊	药物
门冬氨酸钾	药物
痰有恶臭味	症状
甲型肝炎	疾病
至宝三鞭胶囊	药物
滑膜液肉眼检查	检查科目
急性肠系膜上静脉血栓形成	疾病
水线和胃颗粒	药物
腺病毒	病毒
胆汁返流	症状
口腔白斑	疾病
复方利多卡因乳膏	药物
胰高血糖素放射免疫分析药盒	药物
胰腺肉瘤	疾病
次甲氯地孕酮	药物
胃乐新胶囊	药物
小儿感冒茶	药物
贝沥止咳口服液	药物
肾动脉瘤	疾病
酮洛芬凝胶	药物
维胺酯乳膏	药物
茶碱麻黄碱片	药物
甲硝唑口颊片	药物
胫前黑斑	症状
小儿急性胃炎	疾病
小柴胡冲剂	药物
宫颈举痛	症状
儿童焦虑症	疾病
亚硝酸钠	药物
地氯雷他定分散片	药物
劳力性晕厥	症状
氨硫脲	药物
复方维U颠茄铋铝片	药物
同仁乌鸡白凤口服液	药物
头风痛胶囊	药物
膜性肾病	疾病
腓肠肌强直收缩并有疼痛	症状
视神经疾病	疾病
酒石酸托特罗定片	药物
四环素泼尼松眼膏	药物
复方黄柏液	药物
短暂性脑缺血发作	疾病
复方氢氧化铝	药物
血清钠	药物
双黄连栓	药物
口唇泛黑	症状
腐植酸钠片	药物
黄斑前膜	疾病
香通片	药物
人参鳖甲煎丸	药物
消风止痒冲剂	药物
肱骨干骨折	疾病
脑痨	疾病
急性胰腺炎	疾病
甲苯磺丁脲	药物
脾肾阳虚	NoneType
阵发性睡眠性血红蛋白尿	疾病
低分子肝素	药物
化脓性食管炎	疾病
冻干鼠表皮生长因子	药物
舒尔曼病	疾病
玻璃体经瞳孔向前房凸出	NoneType
苋菜黄连素胶囊	药物
继发性铁粒幼细胞性贫血	疾病
甲唑醇	药物
下肢放射痛	症状
钙调素	检查科目
肠道短路关节炎皮炎综合征	疾病
暴力作用后腹痛	症状
降脂通便胶囊	药物
脊柱脊髓伤	疾病
硫酸卡那霉素滴眼液	药物
硫酸阿托品	NoneType
微小病变型肾病	疾病
龙胆泻肝丸	药物
鼻中隔溃疡	NoneType
阿折地平	药物
苏格兰脑炎	疾病
匹莫齐特	药物
乙酰谷酰胺氯化钠注射液	药物
沙眼	疾病
人用狂犬病纯化疫苗(vero细胞)	NoneType
碘酊	药物
脚癣	疾病
小儿结节病	疾病
小儿感冒口服液	药物
七宝美髯颗粒	药物
甲氟喹	药物
小儿清解冲剂	药物
冠状动脉异常起源主动脉	疾病
单纯疱疹病毒肺炎	疾病
结肠破裂	疾病
红细胞丙酮酸激酶	检查科目
醋酸甲地孕酮胶囊	药物
杀鼠剂中毒	疾病
甲状腺球蛋白抗体分析盒	药物
复方维生素U胶囊	药物
阴茎结核疹	疾病
慢性泪腺炎	疾病
桂美辛	药物
烟草依赖综合症	疾病
鹿鞭补酒	药物
脾可欣颗粒	药物
养胃舒颗粒	药物
性病性淋巴肉芽肿	疾病
注射用放线菌素D	药物
愈创甘油醚颗粒	药物
咀嚼肌痉挛	症状
己酮可可碱缓释片	药物
定向力障碍	症状
麝香舒活精	药物
帕米膦酸二钠葡萄糖注射液	药物
盐酸苄达明	药物
蓝花药	药物
红归胶囊	药物
皮肤呈鳞片状	症状
后牙反合	NoneType
耻骨联合分离	症状
冠状动脉粥样硬化性心脏病	疾病
失水	症状
类诺卡氏菌属	细菌
氨氢溴酸加兰他敏注射液	药物
小肠血管畸形	疾病
咽肌痉挛	疾病
多骨纤维发育不良	疾病
栀子提取物	NoneType
春血安胶囊	药物
甲鱼软坚膏	药物
酸溶血试验	检查科目
腹式反常呼吸	症状
关节局部刺痛	症状
促肝细胞生长素颗粒剂	药物
一侧乳头萎缩，另侧水肿	NoneType
人破伤风免疫球蛋白	药物
注射用七叶皂苷钠	药物
复方地茯口服液	药物
肝素钠含片	药物
盐酸克仑特罗片	药物
胰岛素放免药盒	药物
挛缩性瘢痕	NoneType
米力农	药物
出血热预防片	药物
前列舒乐片	药物
双黄连粉针剂	药物
芽孢杆菌属	细菌
高热寒战	症状
血浆蛋白检测试剂冻干纤维蛋白(原)降解物(FDP)诊断血球	药物
马来酸曲美布汀	药物
肾血浆流量	检查科目
风疹减毒活疫苗	药物
肝喜乐颗粒	药物
十味黑冰片丸	药物
跌打按摩药膏	药物
毒品依赖	症状
吉非罗齐片	药物
急性胃痛	症状
复方天麻益阴酒	药物
喉部有痰	症状
消化道穿孔	症状
安非他酮	药物
认知功能损害	症状
马来酸麦角新碱	药物
解心痛片	药物
化积片	药物
老年期谵妄	疾病
子宫内膜不规则脱落	疾病
甲状腺功能减退伴发的精神障碍	疾病
蛛网膜囊肿	疾病
头或颈部发胀及跳动感	症状
阿法骨化醇胶丸	药物
障眼明胶囊	药物
虚寒呕吐	疾病
治伤胶囊	药物
奥美拉唑	NoneType
外用盐酸氨酮戊酸散	药物
传染性淋巴细胞增多症	疾病
血影细胞性青光眼	疾病
胆囊-结肠肝曲粘连综合征	疾病
下部附加前根脊髓动脉缺血症候群	疾病
参苓白术口服液	药物
阳春胶囊	药物
丹参注射液	药物
裂腭	NoneType
囊性纤维化	NoneType
克霉唑栓	药物
半月板损伤	疾病
外阴炎	疾病
蚕蚀性角膜溃疡	疾病
冻疮膏	药物
小儿肺热咳喘口服液	药物
中耳和耳咽管纤毛异常	NoneType
冻可消搽剂	药物
手内肌萎缩	症状
高睾酮血症	疾病
肝破裂	疾病
基底细胞癌	疾病
香菊颗粒	药物
多杀巴斯德氏菌	疾病
复方珍珠口疮颗粒	药物
乙型肝炎病毒表面抗体酶联试剂盒	药物
空间感知障碍	症状
手掌软硬度异常	症状
分离性恍惚状态和附体状态	症状
点状出血	症状
复方普鲁卡因苯甲酸胶囊	药物
二甲茚定	药物
盐酸西替利嗪胶囊	药物
缺乏自控能力	症状
钩端螺旋体肺炎	疾病
网络依赖	症状
抽动障碍	疾病
杵状指（趾）	NoneType
精囊恶性肿瘤	疾病
骨蒸	疾病
轮状病毒抗体	检查科目
言语功能的部分丧失	NoneType
清热神芎丸	药物
清肺十八味丸	药物
威隆壮骨酒	NoneType
小儿黄水疮	疾病
粉碎性骨折	NoneType
黄白色黏痰有水果味	症状
杜仲补腰合剂	药物
髌骨缺失或发育不良	NoneType
甲状腺片	药物
产力异常	症状
脉络膜血管瘤	疾病
肝脾康胶囊	药物
金叶败毒颗粒	药物
参芪温阳栓	药物
复方氨酚苯海拉明胶囊	药物
帕吉林	药物
咽旁间隙感染	疾病
呼吸中可有烂苹果味	症状
杏仁止咳糖浆	药物
复方三维亚铁口服溶液	药物
注射用鹿瓜多肽	药物
钆贝葡胺注射液	药物
耳冻伤	症状
逍遥合剂	药物
更昔洛韦氯化钠注射液	药物
氟化钠	药物
骨关节烧伤	NoneType
盘状红斑	症状
注射用尿激酶	药物
胫骨平台骨折	疾病
胆益宁片	药物
清热八味胶囊	药物
去铁胺	药物
腘肌腱损伤	NoneType
茵花洗液	药物
尼可刹米注射液	药物
成人多囊肾	疾病
类戒断反应	症状
自主性高功能性甲状腺腺瘤	疾病
穿心莲内酯片	药物
便隐血胶体金检测试纸	药物
人类轮状病毒抗体	检查科目
食管囊肿	疾病
蛋氨酸	药物
多抗甲素片	药物
三臣胶囊	药物
肺地丝菌病	疾病
氟米龙滴眼液	药物
三鞭胶囊	药物
氨力农	药物
液	NoneType
中度痛	症状
脊椎结核并发截瘫	疾病
壬二酸	药物
曲安奈德新霉素贴膏	药物
外阴幼稚	NoneType
小儿清咽冲剂	药物
甲硫氨酸	NoneType
弥漫性骨质疏松	症状
米诺环素	药物
碳酸钙咀嚼片	药物
腹部伤口流出粪便样物	症状
尼索地平缓释胶囊	药物
姜片虫病	疾病
午时茶	药物
呼气中有甜臭味	症状
葛根素	药物
口服凝结芽孢杆菌活菌片	药物
清脑降压颗粒	药物
胸壁结核	疾病
健延龄胶囊	药物
痰饮丸	药物
洛伐他汀分散片	药物
心包肿瘤	疾病
通宣理肺丸浓缩丸	药物
氨酚甲硫氨酸胶囊	药物
复方肝浸膏糖浆	药物
西尼地平片	药物
特酚伪麻片	药物
半月线疝	疾病
积雪甙片	药物
冰硼咽喉散	药物
喉头增大	症状
快应茶	药物
舍曲林	药物
富马酸氯马斯汀胶囊	药物
小儿同型胱氨酸尿症	疾病
新生儿肝炎综合征	疾病
蛇胆贝母散	药物
金刚丸	药物
小儿其他沙门菌感染	疾病
眼眶纤维肉瘤	疾病
奶麻	疾病
巨人症	疾病
马来酸氯苯那敏滴丸	药物
面部播散性粟粒状狼疮	疾病
感冒解热颗粒	药物
中长链脂肪乳注射液	药物
泛昔洛韦片	药物
复方枸橼酸喷托维林氯化铵糖浆	药物
腱或腱止点处增粗或钙化	症状
氯普噻吨	药物
小儿维生素E缺乏病	疾病
氯美扎酮片	药物
黏多糖贮积症Ⅱ型	NoneType
依索昔康	药物
盐酸氨溴索口腔崩解片	药物
单纯疱疹病毒性角膜炎	疾病
尘螨过敏性哮喘	疾病
银杏叶软胶囊	药物
三臣散	药物
阿库氯铵	药物
盐酸二氢埃托啡片	药物
咯多量血性泡沫痰	症状
口咽癌	疾病
腺样体炎	疾病
维生素C	NoneType
全身紧束感	症状
表皮囊肿	疾病
洛芬待因片	药物
羊水栓塞	疾病
安脑丸	药物
特非那定片	药物
股骨髁骨折	疾病
丛集性头痛	NoneType
老年人颈性眩晕	疾病
钩藤片	药物
月经稀少	NoneType
代谢性酸中毒	疾病
食管异物	疾病
乳香风湿气雾剂	药物
非IgA系膜增生性肾炎	疾病
钡中毒	疾病
新生儿出血症	疾病
传导性耳聋	症状
双氯芬酸钠缓释胶囊	药物
抗病毒片	药物
斑秃	NoneType
复方右旋糖酐70滴眼液	药物
股四头肌损伤	症状
盐酸二甲双胍片	药物
甲状腺腺瘤	疾病
氯喹中毒	疾病
吡拉西坦分散片	药物
前列腺异位	疾病
胆固醇脓胸	疾病
感冒退热泡腾片	药物
脑血管痉挛	症状
神香苏合丸	药物
氯地孕酮	药物
小儿风热清合剂	药物
甘磷酰芥	药物
食消饮	药物
狮子油	NoneType
小儿复方磺胺甲恶唑颗粒	药物
会呼吸的痛	NoneType
润畅胶囊	药物
奥硝唑片	药物
小儿维斯科特-奥尔德里奇综合征	疾病
盘状红斑狼疮	疾病
抗人免疫球蛋白轻链k/型诊断血清	药物
小儿纵隔囊肿及肿瘤	疾病
益母草冲剂	药物
腹卒中综合征	疾病
丙硫氧嘧啶	药物
亮菌甲素葡萄糖注射液	药物
人绒毛膜促性腺激素	NoneType
肉毒素B	药物
肾上腺素中毒	疾病
过度通气	症状
双胎妊娠	疾病
新清宁胶囊	药物
骨坏死	NoneType
腹水甘油三酯	检查科目
特禀体质	症状
先天性喉闭锁	疾病
肾上腺意外瘤	疾病
棉子中毒	疾病
古汉养生颗粒	药物
醋酸奥曲肽	NoneType
头孢呋辛酯	药物
含糖胃蛋白酶	药物
老年人泌尿系统感染	疾病
黄柏果油软胶囊	药物
排卵障碍	疾病
非结核分枝杆菌病	疾病
鼻部囊肿	疾病
复方间苯二酚水杨酸酊	药物
附桂风湿膏	药物
抗Ku抗体	检查科目
胆固醇肺炎	疾病
前列腺缩小变硬	症状
替奈普酶	药物
铬及其化合物引起的皮肤病	疾病
泪液溶菌酶	NoneType
乳块消片	药物
小儿复方麝香草酚撒粉	药物
思维紊乱	症状
甘芍降糖片	药物
多形性低度恶性腺癌	疾病
磷脂	药物
咪达唑仑	药物
肌氨肽苷注射液	药物
酒石酸布托啡诺鼻喷剂	药物
心肌脓肿	症状
耳疖	疾病
短肽型肠内营养剂	药物
三甲散	药物
痛安注射液	药物
肛廔	NoneType
万应宝珍膏	药物
潮安片	药物
益胆片	药物
异丙肾上腺素	症状
碱式水杨酸铋	药物
吡拉西坦口服溶液	药物
仙灵脾酒	NoneType
抗丁型肝炎病毒IgG抗体	检查科目
山玫胶囊	药物
小儿脊柱裂	NoneType
新生儿脓疱疮	疾病
代谢性碱中毒	疾病
尿道狭窄	疾病
罗红霉素颗粒	药物
下颌第三磨牙冠周炎	疾病
灵芪加口服液	药物
玉金方片	药物
阿那日五味散	药物
血再生片	药物
小儿支原体肺炎	疾病
九圣散	药物
感冒解毒颗粒	药物
胃粘膜脱垂	NoneType
子囊菌	NoneType
珍视明滴眼液	NoneType
龙凤宝片	药物
花蛇解痒胶囊	药物
普卢利沙星	药物
房间隔缺损	疾病
氨酚伪麻那敏泡腾颗粒	药物
变应性血管炎	疾病
宫术安栓	药物
健宝灵颗粒	药物
紫雪	NoneType
隐球菌病补体结合试验	检查科目
安阳膏药	药物
三七血伤宁散	药物
克林霉素磷酸酯溶液	药物
心血管疾病	疾病
同种免疫性新生儿血小板减少性紫癜	疾病
蜡样芽孢杆菌食物中毒	疾病
克咳胶囊	药物
磺胺林	药物
绿色瘤	疾病
混合糖电解质注射液	药物
胍那决尔	药物
维A酸凝胶	药物
顺铂注射液	药物
腹壁切口处有肿物突出	症状
草乌甲素口服液	药物
其他沙门菌感染	疾病
眼外肌外伤	疾病
急性面容	症状
接触性皮炎	疾病
维D2乳酸钙片	药物
颈痛灵胶囊	药物
雌性柞蚕蛾	NoneType
水冲脉	症状
安依痛	NoneType
括约肌功能障碍	症状
克感利咽颗粒	药物
小柴胡汤丸	药物
荧光法密螺旋体抗体吸附试验	检查科目
拇、食、中三指有放射痛	NoneType
尿黑酸尿与褐黄病	疾病
薄荷通吸入剂	药物
复方牵正膏	药物
锑末沉着症	疾病
寰枢脱位	症状
硫酸西索米星	NoneType
愉快感缺乏	症状
多发性肌炎-皮肌炎	疾病
已糖胺全酶	检查科目
复方乳酸钠注射液	药物
慢脾风	疾病
酚麻美敏胶囊	药物
四肢湿冷	症状
痰火	疾病
脊髓血管病	疾病
氯己定甲硝唑乳膏	药物
夏枯草膏	药物
环吡酮	药物
脑脊液溶菌酶	检查科目
小儿肺闭宁片	药物
偏侧不注意	症状
消尔痛酊	药物
驱蛔灵中毒	疾病
圆形或卵圆形丘疹或结节	NoneType
皮肤黏膜出血	症状
口腔疾病	疾病
小肠损伤	疾病
环孢素滴眼液	药物
阿屈非尼	药物
剧烈神经根性痛	症状
小儿黑酸尿综合征	疾病
热带口炎性腹泻	疾病
肼屈嗪	药物
高渗尿	症状
跌打榜药酒	NoneType
复方甘草口服溶液	药物
芪蓉润肠口服液	药物
红色诺卡氏菌细胞壁骨架	药物
前列回春丸	药物
奥索拉明	药物
直肠狭窄	症状
全身肌张力障碍	症状
小儿葡萄状肉瘤	疾病
指甲呈现黑色	症状
半夏露颗粒	药物
癌性神经肌病	疾病
人免疫球蛋白G诊断血清	药物
吡罗昔康凝胶	药物
法制半夏曲	NoneType
初潮痛经	疾病
子宫出血	症状
一氧化碳	NoneType
胶原酶溶液	药物
强力脑心康胶囊	药物
颅底畸形	症状
醋酸氟轻松冰片乳膏	药物
视力视野改变	症状
摇头转颈	症状
动眼危象	NoneType
布洛芬分散片	药物
知柏地黄丸	药物
眼外肌广泛纤维化综合征	疾病
丁芎癣药水	NoneType
干性脚气	症状
赛胃安胶囊	药物
马链球菌	细菌
肾萎缩	疾病
卡那霉素	药物
醋酸曲安奈德	药物
抗骨骼肌柠檬酸提取物抗体	检查科目
中性炎症细胞吞噬试验	检查科目
醋酸氯已定贴膏	药物
头孢呋辛酯干混悬剂	药物
磷酸苯丙哌林缓释片	药物
柴黄软胶囊	药物
重庆市高强度聚焦超声肿瘤治疗中心	NoneType
生长激素分泌过多	症状
四君子丸	药物
心源性晕厥	NoneType
耳内发胀	症状
血液病	疾病
凉解感冒合剂	药物
复方菠萝蛋白酶肠溶片	药物
肠白塞病	疾病
冻干蜂王浆散	药物
獐牙菜苦素	药物
眼睑肿胀且呈淡绿色	症状
洁阴灵洗剂	药物
肠闭锁	症状
注射用盐酸阿克拉霉素	药物
栓塞性肾炎	疾病
肌苷注射液(静注)	药物
小儿烟雾病	疾病
奥美沙坦酯	药物
生脉袋泡茶	药物
半椎体畸形	疾病
五积颗粒	药物
调经养血丸	药物
复方益肝灵胶囊	药物
外阴烧伤、烫伤和化学损伤	疾病
穿琥宁	药物
二硝基氟苯皮肤试验	检查科目
浅表性胃炎	疾病
颞颌关节陈旧性脱位	疾病
尿比重增高	症状
厄多司坦胶囊	药物
苏合香丸	药物
适应障碍	疾病
二尖瓣闭锁不全	疾病
吡嘧司特钾片	药物
龙心素胶囊	药物
汗闭现象	症状
风寒感冒颗粒	药物
琥乙红霉素颗粒	药物
复方可待因口服溶液	药物
强力脑清素片	药物
吡哌酸锌软膏	药物
糙皮病样皮疹	NoneType
裂头蚴病	疾病
咽部异感症	疾病
性欲亢进	NoneType
小儿清肺丸	药物
屈他维林	药物
软骨外胚层发育不全	疾病
阳虚胃痛	症状
梅毒性心血管病	疾病
已稀雌酚片	药物
小青龙颗粒	药物
消风止痛宁胶囊	药物
杆菌性上皮样血管瘤病	疾病
指甲呈三角形	症状
紫雪胶囊	药物
尿道口粘连	症状
烧伤后尿量减少	症状
暴露性角膜炎	疾病
熊胆酒	NoneType
熊胆降热胶囊	药物
盐酸多沙普仑注射液	药物
新生儿B链球菌感染	疾病
色甘酸钠滴眼液	药物
小儿清咽颗粒	药物
颅外头痛	症状
胃苏泡腾片	药物
参鹿强身丸	药物
小儿治哮灵片	药物
妇科养坤丸	药物
中老年饮食营养与保健	NoneType
外用溃疡散	药物
复方祖司麻止痛膏	药物
鲨肝醇片	药物
痛阈降低	症状
混合核苷片	药物
木香顺气丸	药物
天一止咳糖浆	药物
耳源性脑膜炎	疾病
手足发绀症	疾病
丙酸交沙霉素干糖浆	药物
毒蕈碱样症状	症状
胸膜增厚	症状
小儿X-连锁无丙种球蛋白血症	药物
小儿流行性喘憋性肺炎	疾病
风热咳嗽胶囊	药物
脓苔	症状
绿色弱	症状
采云曲	NoneType
美他多辛片	药物
艾附暖宫丸	药物
视乳头水肿	NoneType
肾上腺皮质良性男性化现象	症状
低分子肝素钠	药物
胃痛散	药物
银黄软胶囊	药物
食管癌	疾病
广东凉茶颗粒	药物
酪酸梭状芽胞杆菌制剂	药物
补中益气丸(浓缩丸)	药物
阵发性或强直性惊厥	症状
甲型肝炎病毒IgM抗体诊断试剂盒(酶联免疫法)	药物
肘部外翻角增大	症状
舌质红绛	症状
先天性动静脉瘘	疾病
老化松弛性眼袋	症状
盐酸特比萘芬片	药物
腹腔脓肿	疾病
珍珠散	药物
清淋胶囊	药物
秘诀清凉散	药物
奈西立肽	药物
肾石通颗粒(无糖型)	NoneType
眼距宽阔	症状
双羟萘酸噻嘧啶栓	药物
内容难以听清的自言自语	NoneType
参茸安神丸	药物
手指小关节痛肿	症状
氧氟沙星	药物
血府逐瘀片	药物
益妇止血丸	药物
新生儿吮乳无力及减少	症状
特非那丁片	药物
山玫片	药物
注射用转化糖	药物
易揭纱布	NoneType
身体摇晃征	症状
泪囊炎	疾病
肺门增宽	症状
血管瘤	疾病
周期性动眼神经麻痹	疾病
肩胛骨体部骨折	疾病
茜草双酯	药物
复方手参丸	药物
重组酵母乙型肝炎疫苗	药物
盐酸洛美沙星滴眼液	药物
一过性尿蛋白	症状
棕榈氯霉素混悬液	药物
鸡骨草胶囊	药物
喉部创伤	疾病
老年人风湿性心脏病	疾病
多发性硬化	疾病
牙齿较小呈半透明状	NoneType
糠醛	药物
维生素A缺乏神经病	疾病
边缘性龈炎	疾病
肠系膜动脉瘤	疾病
茵栀黄口服液	药物
麻疹病毒血凝素	NoneType
大株红景天片	药物
小儿月经过多	疾病
胆源性急性胰腺炎	疾病
遗传性凝血因子缺乏症	疾病
妇炎净泡沫气雾剂	药物
鱼腥草注射液	药物
四季三黄软胶囊	药物
肛管反射消失	症状
肌肉硬结	症状
易变性痉挛	NoneType
肠扭转综合征	疾病
仲景胃灵片	药物
被窃或疑病妄想	症状
强握反射	症状
辅酶Q10氯化钠注射液	药物
口酸伴有口苦烧心	症状
低磷血症	疾病
咽反射亢进	症状
盐酸洛美沙星注射液	药物
双氢青蒿素片	药物
耳前淋巴结肿大	症状
瞳孔如锯齿或梅花状	NoneType
利奈唑胺	药物
胰岛细胞类癌	疾病
镍及其化合物引起的皮肤病	疾病
鲍温样丘疹病	疾病
食管黏膜损伤	疾病
乳酸	NoneType
水蜈蚣颗粒	药物
北埔栉大蚊	NoneType
痰毒	疾病
氯解磷定注射液	药物
睡觉流口水	症状
酚磺乙胺葡萄糖注射液	药物
舌甲状腺	疾病
二巯丙醇	药物
喉舒口含片	药物
胎儿水肿	症状
樟脑磺酸钠	药物
舒胃药酒	NoneType
复方鹿茸健骨胶囊	药物
腮腺恶性肿瘤	疾病
氨酚曲麻片	药物
咯血伴黄疸	症状
咳立停糖浆	药物
非典型麻疹综合征	疾病
曲普瑞林	药物
门冬氨酸钙片	药物
腓骨肌对称萎缩逐渐向上发展	症状
简易凝血酶生成试验	检查科目
伊索拉定	药物
肩周区弥散的钝痛及放射痛	症状
安鲁米特	NoneType
苔黄腻	症状
胃、十二指肠溃疡急性穿孔	疾病
心前区隆起	症状
肝脾肿大	症状
妊娠合并自身免疫性溶血性贫血	疾病
婴儿及儿童期癫痫及癫痫综合征	疾病
单氯芬那酸片	药物
晒伤	症状
人类免疫缺陷病毒HIV1/2抗体诊断试剂盒胶体金法	药物
红鼻头	症状
手、足部厚壁水疱	NoneType
运动神经元疾病	疾病
筋骨伤喷雾剂	药物
妇科养荣胶囊	药物
肺动脉口狭窄	疾病
藿香正气丸浓缩丸	药物
羚羊角滴丸	药物
尿道结核	疾病
心房内传导阻滞	疾病
三七化痔丸	药物
壮血药酒	NoneType
复方氯化钾泡腾片	药物
三七止血胶囊	药物
复方胃膜素片	药物
利肝康片	药物
先天性短食管	疾病
肉杆菌属	细菌
尿素软膏	药物
小儿止泻安冲剂	药物
强酸、强碱中毒	疾病
小儿扩张型心肌病	疾病
鼠疫菌F1抗原	药物
醋甲胆碱	药物
股神经卡压综合征	疾病
小儿止嗽丸	药物
磷酸奥司他韦胶囊	药物
膀胱损伤	疾病
脊髓前角病变	症状
玻璃体疝	NoneType
老年人室性期前收缩	疾病
高血氮	症状
宫颈癌栓	药物
大量羊水吸入	疾病
心可舒片	药物
盐酸曲普利啶胶囊	药物
驱白巴布期片	药物
右旋糖酐铁注射液	药物
血管网织细胞瘤	疾病
血宁冲剂	药物
腹部型肥胖	症状
产后子宫收缩	症状
嗜异性凝集吸收试验	检查科目
牙的咀嚼磨损	症状
创伤性气胸	疾病
变形性骨炎	疾病
B因子溶血活性	检查科目
咪达普利	药物
多西紫杉醇	药物
复方咪康唑软膏	药物
次水杨酸铋	药物
枸橼酸铋雷尼替丁	药物
乳白色尿	症状
小儿复方赖氨酸颗粒	药物
凝肩	NoneType
溢乳	症状
虫霉病	疾病
硫酸核糖霉素	NoneType
烧伤感染	疾病
双香排石颗粒	药物
四正丸	药物
新生儿肺气漏	疾病
仙桂胶囊	药物
右苯丙胺	药物
胃阴虚	NoneType
指甲厚脆且多裂纹	症状
宁神灵颗粒	药物
腰大肌痉挛	症状
隐红碱线菌	NoneType
羧甲司坦泡腾片	药物
庚型病毒性肝炎	疾病
人性的弱点	NoneType
华佗再造丸	药物
产科	医学专科
头发枯黄稀疏	症状
吡美莫司	药物
儿童股骨头坏死	疾病
环孢素软胶囊	药物
长骨造釉细胞瘤	疾病
营养不良性肝硬化	疾病
哈西奈德乳膏	药物
血液保存液(II)	药物
复方盐酸金刚烷胺片	药物
肢端易发生不易控制的足癣感染	症状
小儿消食片	药物
腰部包块	症状
烧伤净喷雾剂	药物
银杏叶提取物滴剂	药物
咪康唑	药物
《本草发明》	NoneType
获得性免疫缺陷综合征的神经系统表现	疾病
注射用阿莫西林钠舒巴坦钠	药物
皮肤癌	疾病
阴道持续流血不停	症状
β受体亢进症	疾病
气管纵隔和心脏向健侧移位	症状
结肠类癌	疾病
痤疮样皮疹	症状
八珍益母片	药物
细胞外液减少	NoneType
脊柱后突	症状
哌硝噻唑	药物
那如八味丸	药物
简单纯芽孢杆菌	NoneType
胆石清片	药物
血浆蛋白检测试剂C反应蛋白(CRP)抗血清	NoneType
枕叶肿瘤	疾病
硫酸软骨素胶囊	药物
吲达品	药物
肾小管氨马尿酸最大排泄量试验	检查科目
八味獐牙菜丸	药物
糖原贮积病Ⅴ型	疾病
水杨酸氧化锌软膏	药物
高渗性非酮症性糖尿病昏迷	NoneType
腮腺炎片	药物
夸大狂	症状
血吸虫虫卵抗体诊断试剂(血凝法)	NoneType
温胃降逆颗粒	药物
核黄素磷酸钠注射液	药物
曲美苄胺	药物
布洛芬混悬液	药物
黄芪颗粒	药物
第二性征改变	症状
颅内转移瘤	疾病
阿罗洛尔	药物
百科	NoneType
金鸡虎补丸	药物
盐酸阿比多尔	药物
参苓白术胶囊	药物
磷酸克林霉素	药物
亚砷酸注射液	药物
复方水杨酸苯甲酸搽剂	药物
蒲苓盆炎康颗粒	药物
肢体肿胀	症状
舟车丸	药物
复方满山红胶囊	药物
查加斯病	疾病
血管免疫母细胞性淋巴结病	疾病
天麻首乌片	药物
归脾胶囊	药物
平衡功能障碍	症状
蛔虫性急性胰腺炎	疾病
浓缩水牛角颗粒	药物
健肝灵胶囊	药物
雅叫哈顿散	药物
桑麻丸	药物
骨不连	疾病
藿香祛暑水	药物
牛黄清脑开窍丸	药物
脉络膜脱离型视网膜脱离	疾病
硝酸银软膏	药物
氯索隆	药物
倍氯米松	药物
多索茶碱胶囊	药物
麝香跌打软膏	药物
胃液锌	检查科目
学习障碍	症状
静脉栓塞	症状
香砂平胃丸	药物
雄异噁唑	药物
跌打扭伤灵酊	药物
地氯雷他定干混悬剂	药物
反复舔吮口唇	症状
小脑幕脑膜瘤	疾病
制霉素阴道栓	药物
维E三油胶丸	药物
抑眩宁胶囊	药物
病毒性胃肠炎	疾病
小儿肥胖通气不良综合征	疾病
芩暴红止咳颗粒	药物
抗单链DNA(ssDNA)抗体	检查科目
胍法辛	药物
旋转带肌腱炎	疾病
肉蔻四神丸	药物
类芽孢杆菌属	细菌
骨质软化症与佝偻病	疾病
奥诺前列素	药物
儿童抽动障碍	疾病
消积化虫散	药物
注意力缺乏多动症	疾病
肌醇烟酸酯软膏	药物
慢性肾功能衰竭	疾病
童年情绪障碍	疾病
康复新	NoneType
眼痛	症状
内分泌性肌病	疾病
安神宁	药物
浅表性皮肤脂肪瘤痣	疾病
蹄甲多肽片	药物
神经胶质瘤	疾病
口疳吹药	药物
产妇安口服液	药物
胃脘饱胀	症状
小儿曳足而行	症状
急性颈椎间盘突出症	疾病
炔雌醇	NoneType
杏灵滴丸	药物
大小便潴留	症状
婴儿脸色发黄	症状
节杆菌	NoneType
肺炎克雷白杆菌肺炎	疾病
心境不良	症状
对苯二胺皮炎	疾病
铁帚清浊丸	药物
养血安神丸	药物
乙哌立松	药物
抗病毒泡腾片	药物
奥美拉唑微丸	药物
环磷酰胺片	药物
口腔念珠菌感染	症状
一侧颜面肥大	症状
顶叶肿瘤	疾病
局限性硬皮病	疾病
浓缩养荣丸	药物
湿疹	NoneType
先兆流产	疾病
宫颈炎	疾病
晕厥预兆	症状
利德尔综合征	疾病
中华肝灵胶囊	药物
八宝惊风散	药物
中枢神经系统淋巴瘤	疾病
黄连上清胶囊	药物
失血过多后贫血	症状
变色镜片	NoneType
注射用青霉素钾	药物
晕机	NoneType
盐酸普萘洛尔	药物
骨髓的发育异常	症状
神经系统先天性疾病	疾病
风痛药酒	NoneType
黏膜相关样组织淋巴瘤	疾病
外翻	症状
喷他佐辛注射液	药物
丙氧氨酚复方片	药物
多指（趾）畸形	NoneType
残胃癌	疾病
人参卫生丸	药物
五淋化石胶囊	药物
依诺肝素钠	药物
癌胚抗原定量测定试剂盒(酶联免疫法)	药物
孢草绿链霉菌	NoneType
哌泊噻嗪棕榈酸酯	药物
金钱胆通口服液	药物
肾盏结石	症状
催乳素	药物
脉络膜转移癌	疾病
金马肝泰颗粒	药物
利托那韦口服溶液	药物
维生素A	NoneType
萘丁美酮胶囊	药物
嗜酒性幻觉性精神错乱	NoneType
妊娠合并卵巢肿瘤	疾病
当归南枣颗粒	药物
壮腰健身丸	药物
补中益气汤	药物
左布诺洛尔	药物
顽癣敌软膏	药物
腺苷蛋氨酸	药物
玄胡止痛片	药物
盐酸克仑特罗膜	药物
羚黄氨咖敏片	药物
小儿风热清颗粒	药物
亨廷顿病性痴呆	疾病
参苓白术颗粒	药物
肉芽肿性前列腺炎	疾病
复方鸡血藤膏	药物
复合维生素B注射液	药物
三高症	疾病
线状骨折	症状
精氨酰琥珀酸裂解酶	NoneType
肋软骨炎	疾病
胃苏冲剂	药物
突然出现剧烈的腰痛	症状
小儿宝泰康颗粒	药物
皮下气肿	症状
肾动静脉瘘	疾病
恶性青光眼	疾病
鼻部脑膜脑膨出	疾病
小儿营养不良性水肿	疾病
硬红斑	疾病
排便时间过长	症状
复方氨基比林注射液	药物
牙龈囊肿	疾病
原发性食管恶性黑色素瘤	疾病
背部痉挛	症状
脐炎	疾病
板蓝根含片	药物
破伤风类毒素	药物
铺路石样变性	症状
杏灵颗粒	药物
普莫卡因	药物
复方苯巴比妥溴化钠片	药物
注射用盐酸艾司洛尔	药物
八味西红花止血散	药物
杀虫丸	药物
间质性肾炎	疾病
四君子颗粒	药物
复方藏红花油	药物
退障眼膏	药物
靶样含铁血黄素沉积性血管瘤	疾病
锥体束病损	症状
三痹	NoneType
克淋通胶囊	药物
甲状腺球蛋白抗体放射免疫分析药盒	药物
黑头粉刺痣	NoneType
高血压肾病	疾病
口炎清颗粒	药物
收缩期反流性杂音	症状
双侧睑外翻	症状
清热八味散	药物
虫草头孢菌胶囊	药物
尿酸化异常	症状
表皮松解性棘皮瘤	疾病
鼻疽假单胞菌肺炎	疾病
单纯性外阴阴道念珠菌病	疾病
直接型颈动脉海绵窦瘘	疾病
肝胆外科	医学专科
粪细菌培养	NoneType
铝碳酸镁	药物
泻痢消胶囊	药物
眠安宁合剂	药物
维生素A中毒症	疾病
复方紫参冲剂	药物
死产	症状
脾肿大	症状
嗅觉障碍	NoneType
红细胞畸形	症状
尿比重下降	症状
磷烧伤合并中毒	疾病
腺性膀胱炎	疾病
注射用硫酸核糖霉素	药物
双黄连	药物
硫酸镁	药物
双氯芬酸钠栓	药物
技术狂躁症	疾病
紫癜	症状
读小字和辨色困难	症状
追风活血膏	药物
指甲末端呈直线形	症状
反复肺不张	症状
蜈蚣蜇伤	疾病
老年人单纯疱疹病毒性脑炎	疾病
四味雪莲花颗粒	药物
白癜风	疾病
环状红斑	疾病
尼尔雌醇片	药物
头孢地秦钠	药物
香菊胶囊	药物
椎体骨软骨病	疾病
肠多糖	药物
神经母细胞瘤	疾病
早泄	疾病
老年人急性呼吸窘迫综合征	疾病
产后康膏	药物
创伤性肘关节炎	疾病
利巴韦林喷雾剂	药物
小儿用氨基酸注射液(18)	药物
脑发育不良	疾病
左炔诺孕酮	药物
疼痛性眼肌麻痹	疾病
鼻通滴鼻剂	药物
手腕在大拇指侧的疼痛	症状
氨丁三醇注射液	药物
硫酸亚铁片	药物
盐酸奥昔布宁胶囊	药物
乌苯美司	药物
田基黄糖浆	药物
克拉霉素	药物
头皮松垂	疾病
衣原体检测试剂盒(胶体金法)	药物
小儿消食咀嚼片	药物
贝前列素	药物
静脉血流滞缓	NoneType
周围组织灌注不良	症状
丹芎瘢痕涂膜	药物
注射用氯唑西林钠	药物
张嘴颌骨响	症状
老年性心瓣膜病	疾病
骨刺宁胶囊	药物
羚翘解毒片	药物
骨赘大量增生	症状
消化管蠕动不协调	症状
生血片	药物
阿维A	药物
癫痫伴发的精神障碍	疾病
小儿麻甘颗粒	药物
黄英咳喘糖浆	药物
血性恶露	NoneType
胃内隔膜	疾病
三七脂肝丸	药物
神经性厌食	症状
复方炔诺孕酮滴丸	药物
复方公英片	药物
别嘌醇缓释片	药物
棘上韧带损伤	疾病
布氏菌纯蛋白衍生物	药物
万古霉素	药物
酮咯酸氨丁三醇滴眼液	药物
骨淋巴管瘤	疾病
甲型副伤寒菌诊断菌液	药物
胁部肿胀	症状
外用重组人碱性成纤维细胞生长因子	NoneType
食管平滑肌瘤	疾病
手外科	医学专科
癫痫宁片	药物
保安万灵丸	药物
晨起前额疼，午后减轻	NoneType
哮鸣音	症状
其他类精神活性物质依赖	疾病
伊木萨克片	药物
小儿溃疡性口炎	疾病
巨细胞动脉炎性巩膜炎	疾病
血红素结合蛋白	检查科目
维血宁冲剂	药物
蠲哮片	药物
外阴血吸虫病	疾病
富马酸阿奇霉素	NoneType
补天灵片	药物
肾性骨质软化	症状
肺内病变	症状
促甲状腺激素	药物
葶苈草颗粒	药物
马来酸氯苯那敏	药物
脊髓梅毒	疾病
六味地黄片	药物
康复新液	药物
富马酸喹硫平	药物
重组人p53腺病毒注射液	药物
肠内营养混悬液(SP)	药物
烧烫宁喷雾剂	药物
卵巢成熟畸胎瘤	疾病
盐酸丁卡因凝胶	药物
金蒲胶囊	药物
氨苄西林丙磺舒口腔崩解片	药物
童康片	药物
乙肝益气解郁颗粒	药物
扎来普隆分散片	药物
眶下间隙感染	疾病
磺胺嘧啶锌	NoneType
尾骨骨折与脱位	疾病
氯硝柳胺	药物
止血祛瘀明目片	药物
冲动型人格障碍	NoneType
尿游离皮质醇	NoneType
特发性皮肤钙化病	疾病
先天性睑裂狭小综合征	疾病
麻杏止咳颗粒	药物
注射用长春西汀	药物
异亮氨酸	NoneType
云南白药胶囊	药物
精制冠心片	药物
血小板型假性血管性血友病	疾病
春季结膜炎	疾病
蛇胆姜粒	药物
选择性缄默症	疾病
熊胆跌打膏	药物
动脉血氧饱和度降低	症状
使君子丸	药物
指尖边缘指甲有凹陷	症状
X-现象	症状
小儿输尿管脱垂	疾病
脚气病性心脏病	疾病
喉炎	疾病
枸橼酸铋雷尼替丁片	药物
尿胆原增加	症状
小儿过敏性紫癜肾炎	疾病
调胃丹	药物
放线菌病	疾病
舒眠片	药物
盆腔肿瘤	疾病
注射用盐酸四环素	药物
下背部酸痛	症状
小儿急性中毒	疾病
心脏骤停与心肺脑复苏	疾病
氨基葡萄糖	药物
烟酰胺	药物
天麻钩藤颗粒	药物
下身肥胖	症状
恋物癖	NoneType
舒张压上升	症状
福莫特罗	药物
那格列奈胶囊	药物
血府逐淤口服液	药物
巴氨西林	药物
奥迪括约肌功能异常	疾病
血安胶囊	药物
当飞利肝宁片	药物
调经化瘀丸	药物
齐多夫定注射液	药物
外用跌打止痛膏	药物
莲必治注射液	药物
海呋龙散	药物
三黄膏	药物
小柴胡丸	药物
左心衰竭	症状
射精功能障碍	疾病
甘草酸单铵半胱氨酸氯化钠注射液	药物
无症状型溃疡	症状
肺癌皮肤转移	疾病
抗乙肝转移因子口服液	药物
野马追颗粒	药物
百令胶囊	药物
蛾苓丸	药物
蓝鼓膜与胆固醇肉芽肿	疾病
大蒜素肠溶胶丸	药物
肾上腺髓质功能亢进	疾病
有益元素	NoneType
药用灸条	药物
健脾资生丸	药物
关节止痛膏	药物
氨茶碱栓	NoneType
门静脉血流郁滞	症状
门冬氨酸钙注射液	药物
小儿热速清颗粒	药物
甲苯磺酸托氟沙星	药物
镇江橡胶膏	药物
大腿局部肿胀变形	NoneType
逆行性细菌感染	症状
经舒颗粒	药物
珠子肝泰胶囊	药物
肠胃宁胶囊	药物
烟酰胺片	药物
伤寒Vi多糖疫苗	药物
胃复舒胶囊	药物
氨基己酸	药物
单纯红细胞再障性贫血	疾病
先天性梅毒性肝硬化	疾病
子宫性不孕	疾病
外阴横纹肌肉瘤	疾病
毛孢子菌病	疾病
遗传性肥胖	症状
磷霉素钙片	药物
脊髓小脑性共济失调	疾病
氯沙坦钾片	药物
骨代谢减低	症状
复方醋酸环丙孕酮片	药物
唇疱疹	疾病
猴菇饮	药物
安乃近氯丙嗪注射液	药物
腋毛变稀少	症状
性病科	医学专科
对氨马尿酸钠	药物
绝汗	NoneType
复方拳参片	药物
单硝酸异山梨酯喷雾剂	药物
左氧氟沙星片	药物
小儿止泻膏	药物
乳块消颗粒	药物
曲伐沙星	药物
复方氨酚烷胺颗粒	药物
对乙酰氨基酚混悬滴剂	药物
羊水粪染	症状
光年	NoneType
脑器质性精神障碍	症状
眼前冒紫烟	症状
枸橼酸铋钾口服溶液	药物
绦虫病	疾病
青少年脊柱侧凸	症状
血平胶囊	药物
厚元行气丸	药物
脱氧核糖核酸染色	检查科目
纵隔副神经节起源的肿瘤	疾病
乙型肝炎病毒核酸荧光定量检测及YMDD变异检测试剂盒	药物
四黄清心丸	药物
菠萝蛋白酶肠溶片	药物
胎产金丹	药物
三维樟柳碱膜	药物
小儿埃莱尔-当洛综合征	疾病
和肝利胆冲剂	药物
甘草酸二钠	药物
喹碘方	药物
复方党参片	药物
坚强芽孢杆菌	NoneType
复方盐酸普鲁卡因胶囊	药物
胆道运动功能障碍综合征	疾病
硫酸特布他林氯化钠注射液	药物
热毒清片	药物
健脾颗粒	药物
人参蜂王浆胶囊	药物
游走性舌炎	疾病
溃疡病出血	疾病
丙谷胺胶囊	药物
违拗症	疾病
臌症丸	药物
止泻冲剂	药物
红细胞烯醇化酶	NoneType
复方奎宁注射液	药物
窝状角质松解症	疾病
杀鲑气单胞菌	NoneType
消瘰丸	药物
乙酰吉它霉素胶囊	药物
慢性黏膜皮肤念珠菌病	疾病
髌前空虚感	症状
青少年型牙周炎	疾病
用药过程中出现胃部症状	症状
乳房湿疹	疾病
多梦	症状
生长激素缺乏症	疾病
鱼鳞癣样红皮	症状
酚氨咖敏胶囊	药物
非肾上腺素增生性假两性畸形	疾病
活血止痛散	药物
妇科白凤胶囊	药物
阿莫西林克拉维酸钾颗粒	药物
舒筋健腰丸	药物
益肾十七味丸	药物
阿昔洛韦眼膏	药物
舒筋定痛喷雾剂	药物
Thygeson浅层点状角膜病变	疾病
小儿复方鸡内金散	药物
盐酸噻氯匹定胶囊	药物
细菌性心内膜炎	疾病
黑棘皮瘤	疾病
地芬尼多	药物
环状芽孢杆菌	NoneType
亚锡葡庚糖酸钠冻干品	NoneType
奥沙利铂甘露醇注射液	药物
性腺发育不良	症状
二巯丁二酸胶囊	药物
舒气丸	药物
突发的左心衰竭	症状
常染色体显性多囊肾	疾病
补肾强身片	药物
休止期脱发	疾病
低分子肝素钠凝胶	药物
蜂窝织炎	疾病
性病	疾病
都梁滴丸	药物
尿脂肪	检查科目
排便频率异常	症状
钠钾镁钙葡萄糖注射液	药物
养荣丸	药物
当归南枣胶囊	药物
氯法齐明软胶囊	药物
咽后壁憩室	疾病
胸水	症状
消耗性体重下降	症状
霍乱	疾病
乳腺导管扩张症	疾病
囊性坏死	症状
头皮下血肿	症状
分清五淋丸	药物
萘普生肠溶微丸胶囊	药物
促脉	症状
左舒必利	药物
腹型偏头痛综合征	疾病
外踝呈现凹陷	症状
洛非西定	药物
鲜红斑痣	疾病
血清镁	检查科目
环吡酮胺	药物
知柏地黄片	药物
清热导滞散	药物
老年人肺栓塞	疾病
不自主运动	症状
西瓜	NoneType
呋喃西林乳膏	药物
参芪五味子颗粒	药物
伸筋丹胶囊	药物
镁钙维C片	药物
抗链球菌型M蛋白抗体	检查科目
注射用苯唑西林钠	药物
口唇皲裂	症状
新生儿胆红素脑病	疾病
硬脊膜下脓肿	疾病
角膜炎	疾病
香叶醇软胶囊	药物
过氧化氢	NoneType
丁丙诺啡	药物
运动腹痛	症状
枸杞消渴胶囊	药物
手指屈肌腱鞘炎	疾病
注射针眼和手术切口出血	症状
糖尿病肾病	疾病
葡萄糖酸锌	药物
珍菊降压片	药物
盗汗	NoneType
罗格列酮片	药物
铍及其化合物引起的皮肤病	疾病
骶骨骨折	疾病
氟轻松维B6乳膏	药物
环己二胺硫酸铂	药物
骨质宁搽剂	药物
氟骨三醇	药物
小儿关节弯曲综合征	疾病
氟哌噻吨	药物
橘贝半夏冲剂	药物
急性心包炎	疾病
炎症性腹主动脉瘤	疾病
双黄连注射液	药物
颈肋	疾病
强直性脊柱炎性巩膜炎	疾病
醋酸钠	药物
葡萄球菌性食物中毒	疾病
小儿肝硬化	疾病
赛克立明	药物
氟地西泮	药物
寒痹	疾病
地奥心血康颗粒	药物
克拉霉素颗粒剂	药物
复方甘草氯化铵糖浆	药物
更昔洛韦眼用凝胶	药物
蹄甲多肽	药物
儿童感热清丸	药物
肺部良性肿瘤	疾病
盐酸阿米洛利	药物
依氟鸟氨酸	药物
不排胎便	症状
难治性癫痫	疾病
胸椎椎管狭窄症	疾病
颈部纤维瘤	疾病
反复发作右肺感染	症状
抗利尿激素(ADH)分泌减少	症状
细胞色素C氧化酶缺乏症	疾病
贫血	NoneType
“三偏”症	疾病
含化上清片	药物
金匮肾气片	药物
甲麦角林	药物
阴毛脱落	症状
水痘性角膜炎	疾病
瑞香素	药物
苄普地尔	药物
口腔颌面部火器伤	疾病
新生儿低镁血症	疾病
肝血管平滑肌脂肪瘤	疾病
左下腹部可触及压痛性包块	症状
复方氟尿嘧啶片	药物
椎体严重楔形变并伴小关节半脱位	疾病
小儿单侧肺异常透亮综合征	疾病
心宝丸	药物
利咽解毒颗粒	药物
咽部狼疮	疾病
左旋卡尼汀注射液	药物
白陶土部分凝血活酶时间	NoneType
感通片	药物
麻杏宣肺颗粒	药物
银翅解毒丸	药物
保胎灵	药物
阵挛-强直型	症状
绞股蓝总甙颗粒	药物
赛庚啶乳膏	药物
抽搐	症状
会阴溃疡	症状
非淋球菌性细菌性关节炎	疾病
普罗雌烯	NoneType
小儿过敏症	疾病
假单胞菌	细菌
鼻炎灵片	药物
睡眠节律紊乱	症状
丛毛单胞菌	NoneType
香荷止痒软膏	药物
尾部疼痛而拒坐	症状
胸部隐痛	症状
肠炎宁胶囊	药物
卵泡囊肿	疾病
腺性或囊性膀胱炎	疾病
贝母枇杷糖浆	药物
酒精中毒性肌病	疾病
铁线虫病	疾病
溶血葡萄球菌	NoneType
O139群霍乱弧菌检测试剂盒(胶体金法)	药物
氯乙烷	药物
骨雅司病	疾病
疋氏（Pickweckian）综合征	疾病
睑结膜沙粒外观	症状
苄噻嗪	药物
腓骨肌萎缩症	疾病
腺苷钴胺片	药物
六味锦鸡儿汤散	药物
白淫	疾病
牙源性黏液瘤	疾病
压迫瘘口试验	检查科目
骨质增生	症状
黏液纤维肉瘤	疾病
盐酸克林霉素氯化钠注射液	药物
香药胃安胶囊	药物
五黄膏	药物
口咽部水疱状损害	症状
先天性再生障碍性贫血	疾病
益肾安神膏	药物
枫蓼肠胃康片	药物
硫酸西索米星氯化钠注射液	药物
艾地苯醌片	药物
开光复明丸	药物
泛影酸钠注射液	药物
蛤蚧定喘胶囊	药物
人参首乌精	药物
注射用绒促性素(HCG)	药物
丑胎	疾病
甲苯磺酸舒他西林颗粒	药物
膈膨升	症状
热淋清咀嚼片	药物
胰腺囊肿	疾病
眶周水肿	症状
乳房和生殖器萎缩	症状
异丁司特	药物
慢性硬化性颌骨骨髓炎	疾病
秋梨润肺膏	药物
恐惧	症状
三磷酸腺苷二钠氯化钠注射液	药物
注射用布美他尼	药物
大块肝细胞坏死	症状
骨髓造血细胞再生障碍	症状
丹痧	疾病
盐酸氮芥注射液	药物
金属音调咳嗽	症状
五迟	疾病
羟钴胺	药物
谷氨酸钠注射液	药物
蔗糖铁注射液	药物
维生素D缺乏性手足抽搐症	疾病
云香精	药物
蚊子叮咬	疾病
富马酸比索洛尔胶囊	药物
注射用磺巯嘌呤钠	药物
巴氯芬	药物
玉屏风滴丸	药物
足趾伸屈时足部疼痛	症状
复方罗布麻颗粒	药物
盐酸恩丹西酮片	药物
短缩舌	症状
高致病性禽流感病毒感染	疾病
异丙肌苷	NoneType
西洋参颗粒	药物
颅面骨畸形	症状
小肠结肠炎耶尔森菌肠炎	疾病
甲芬那酸片	药物
绝经期关节炎	疾病
叶下珠胶囊	药物
奥沙普嗪分散片	药物
碳酸钙颗粒剂	药物
肠系膜上动脉综合征	疾病
暑症片	药物
酒精性心肌	症状
五子衍宗片	药物
七味广枣丸	药物
脊椎僵直	症状
尿肌酸	NoneType
颈髓脱髓鞘性病变	症状
温抗体型自身免疫性溶血性贫血	疾病
成人牙周炎	疾病
面具脸	症状
维生素C钙	NoneType
甲异靛片	药物
果糖氯化钠注射液	药物
少枝胶质细胞瘤及间变少枝胶质细胞瘤	疾病
足背部肿胀	症状
盲肠阿米巴肉芽肿	NoneType
甲紫溶液	药物
儿童骨缺损	症状
苯中毒	疾病
依西美坦	药物
肝气犯脾	症状
丹芎通脉颗粒	药物
非酮症高血糖-高渗性昏迷	疾病
尿渗透压下降	症状
消渴灵颗粒	药物
龙掌口含液	药物
腺病毒性肺炎	疾病
化毒丹	药物
小儿的异嗜症状	症状
稳心胶囊	药物
腮腺肿大	症状
太阳中风	疾病
流行性斑疹伤寒	疾病
病毒性上呼吸道感染	NoneType
阿霉素	药物
地贝卡星	药物
泌乳障碍	症状
双氯芬酸二乙胺乳胶剂	药物
小儿脑性瘫痪	疾病
异丙托溴铵	药物
睡眠麻痹	症状
香连止泻片	药物
柴黄片	药物
胃切除术后内疝	疾病
血管硬化	症状
风热犯肺	疾病
尿素乳膏	药物
神曲胃痛胶囊	药物
打呼噜	症状
杏仁止咳颗粒	药物
香连丸(浓缩丸)	NoneType
放射性周围神经病	疾病
注射用伏立康唑	药物
雌激素	检查科目
匹伐他汀	药物
脾胃湿热	症状
格列本脲二甲双胍片	药物
白发	疾病
肛门区红肿及痛性硬块	症状
氯苯那敏	药物
巨阴症	疾病
手部功能完全丧失	症状
佐米曲普坦	药物
口腔颌面部软组织挫裂伤	疾病
活血止痛胶囊	药物
尿丙氨酸氨基肽酶	检查科目
胃粘膜脱垂症	疾病
单纯性肾囊肿	疾病
肺宁丸	药物
复方甘草甜素	药物
注射用单硝酸异山梨酯	药物
小儿46-XY单纯性腺发育不全综合征	疾病
山梨醇	药物
盐酸氯丙嗪	药物
萘普生钠	药物
老年人肺结核	疾病
碳酸钙D3咀嚼片	药物
格列吡嗪缓释胶囊	药物
消炎利胆片	药物
子宫破裂征象	症状
葡萄糖酸锌片	药物
膀胱不发育与发育不全	疾病
乌鸡增乳胶囊	药物
孕产妇腰痛	症状
腹膜后纤维化	疾病
康复力假尾孢	NoneType
肾衰宁颗粒	药物
盐酸苯海拉明	药物
盐单胞菌	NoneType
复发性口腔阿弗他溃疡	疾病
分泌性中耳炎	疾病
皮肤闪电疼痛	症状
复方仙灵风湿酒	药物
老年人假膜性小肠结肠炎	疾病
血宝胶囊	药物
手热	症状
神经根型颈椎病	疾病
乌苯美司胶囊	药物
盐酸精氨酸葡萄糖注射液	药物
吲达帕胺	药物
青霉素皮试剂	药物
眼外转移	症状
雀麦花叶病毒	NoneType
周期性发作的巩膜充血	症状
莱阳梨止咳口服液	药物
急性颌下腺炎	疾病
癔症	疾病
降脂减肥胶囊	药物
盐酸多巴胺	药物
抗病毒口服溶液	NoneType
颈椎小关节创伤性退变性关节炎	疾病
儿宝膏	药物
辣椒碱	药物
葫芦素片	药物
中叶综合征	疾病
谷海生片	药物
熊胆舒肝利胆胶囊	药物
毛囊性黏蛋白病	疾病
眉下垂或位置低	症状
乌拉地尔氯化钠注射液	药物
肺组织细胞增生症	疾病
老年低温症	疾病
唇腭裂	疾病
伤风咳茶	药物
口角和鼻周出现黄白色水疱	NoneType
阴部鲍恩样丘疹病	疾病
慢性湿疹样变	症状
滑膜炎痤疮脓疱病骨肥厚骨髓炎综合征	疾病
异位ACTH综合征	疾病
山楂精降脂片	药物
小儿肾母细胞瘤	疾病
眠安宁颗粒	药物
消癌平咀嚼片	药物
妙灵丸	药物
烟草花叶病毒	NoneType
解郁肝舒胶囊	药物
戊已丸	药物
肠炎	疾病
痴呆综合征	疾病
小儿急性血源性骨髓炎	疾病
肾实质性高血压	疾病
表皮葡萄球菌	细菌
夏天无注射液	药物
盐酸苯氨咪唑啉片	药物
头沉	症状
克立法胺	药物
不良睡眠卫生	症状
脑脊液钙	NoneType
颚口线虫病	疾病
知柏地黄口服液	药物
固本咳喘胶囊	药物
四肢屈侧出现橘皮样外观	症状
干性咳嗽	症状
尿路通胶囊	药物
盐酸洛美沙星	药物
颈椎骨折伴脱位的损伤	疾病
牙痛一粒丸	药物
耳、鼻、软骨变成蓝色	NoneType
瘀血痹胶囊	药物
慢性乳腺炎	疾病
老年人院内获得性肺炎	疾病
磷酸伯氨喹片	药物
原发性鼻腔淋巴瘤	疾病
水、钠潴留性肥胖症	症状
非依赖性物质伴发依赖	疾病
小儿安乃近灌肠液	药物
铝镁匹林片	药物
睫毛掉落	症状
神经元移行异常	症状
自恋	NoneType
克补片	药物
皮肤弹性差	症状
玉泉颗粒	药物
尿微量白蛋白定量测定试剂盒(酶联免疫法)	药物
更年期功血	症状
抗胰岛素受体抗体	检查科目
关节肿大	症状
鼻孔闭锁	症状
胃乐胶囊	药物
阴道排出碎块组织	症状
正气片	药物
口	NoneType
胃友新片	药物
木瓜酶肠溶片	药物
挑剔嘴	症状
尿镁	NoneType
参灵肝康胶囊	药物
胰高糖素瘤综合征	疾病
烧伤后急性肾功能不全	疾病
特发性面神经瘫痪	症状
丹郁骨康丸	药物
组织细胞增殖症	疾病
灭菌注射用水	药物
气郁体质	症状
镜面舌	NoneType
下肢发凉	症状
肝外胆管结石	NoneType
肾性糖尿	症状
肝水解物	NoneType
维生素B4片	药物
参胶胶囊	药物
外阴恶性颗粒细胞瘤	疾病
老年人睡眠呼吸暂停综合征	疾病
胱氨酸	NoneType
十六味马蔺子丸	药物
梅苏丸	药物
乌兰十三味汤散	药物
盐酸吡硫醇	药物
老年人尿崩症	疾病
口腔结核	疾病
心阳虚	疾病
窦性心动过缓	疾病
异柠檬酸脱氢酶	检查科目
单硝酸异山梨酯氯化钠注射液	药物
选择性IgA缺乏症	疾病
婴幼儿舌下囊肿	疾病
胰腺损伤	疾病
皮肤肿瘤	疾病
镇坎散	药物
坤灵丸	药物
四环素	药物
双虎肿痛宁喷雾剂	药物
小儿结节性甲状腺肿	疾病
盐酸非那吡啶片	药物
止血复脉合剂	药物
雪哈大补素片	药物
元胡止痛胶囊	药物
注射用氨力农	药物
双氯芬酸钠缓释片	药物
核黄素四丁酸酯胶囊	药物
胃损伤	疾病
对乙酰氨基酚缓释干混悬剂	药物
铝塑复合密封垫片	药物
注射用头孢米诺钠	药物
参茸三七酒	NoneType
糖尿病合并低血糖	疾病
甲胎蛋白放射免疫分析药盒	药物
神经性耳鸣	疾病
左乙拉西坦	药物
高血压脑出血	疾病
疤痕体质	症状
硫酸卡那霉素片	药物
乳宁片	药物
乳核散结片	药物
肾咳	疾病
溶酶体酶缺陷	NoneType
保心宁胶囊	药物
皮肤硬结冷时疼痛热时瘙痒	症状
金硫葡糖	药物
肌病肾病性代谢综合征	疾病
比拉米可	药物
指甲很短	症状
透析性骨关节病	疾病
青霉胺	药物
Turcot综合征	疾病
阿苯达唑糖丸	药物
手指发绀或坏死	症状
醋酸曲安奈德注射液	药物
梗阻性肾病	疾病
维生素B12缺乏所致贫血	疾病
甲硝唑	NoneType
联苯苄唑栓	药物
甲磺酸培高利特	药物
听神经瘤	疾病
